DG;Deutschland;unter 3 Jahre;2022108;1036432;985676
DG;Deutschland;3 bis unter 6 Jahre;2067574;1061077;1006497
DG;Deutschland;6 bis unter 10 Jahre;2834869;1454047;1380822
DG;Deutschland;10 bis unter 15 Jahre;3907537;2004013;1903524
DG;Deutschland;15 bis unter 18 Jahre;2387183;1226352;1160831
DG;Deutschland;18 bis unter 20 Jahre;1693279;868438;824841
DG;Deutschland;20 bis unter 25 Jahre;4959920;2537958;2421962
DG;Deutschland;25 bis unter 30 Jahre;4990602;2543493;2447109
DG;Deutschland;30 bis unter 35 Jahre;4942914;2505090;2437824
DG;Deutschland;35 bis unter 40 Jahre;4785171;2425249;2359922
DG;Deutschland;40 bis unter 45 Jahre;6363154;3247053;3116101
DG;Deutschland;45 bis unter 50 Jahre;7137634;3646794;3490840
DG;Deutschland;50 bis unter 55 Jahre;6422953;3244803;3178150
DG;Deutschland;55 bis unter 60 Jahre;5550054;2754763;2795291
DG;Deutschland;60 bis unter 65 Jahre;4898241;2403404;2494837
DG;Deutschland;65 bis unter 75 Jahre;9040798;4265968;4774830
DG;Deutschland;75 Jahre und mehr;7839752;2981729;4858023
DG;Deutschland;Insgesamt;81843743;40206663;41637080
01;  Schleswig-Holstein;unter 3 Jahre;67378;34588;32790
01;  Schleswig-Holstein;3 bis unter 6 Jahre;71803;36854;34949
01;  Schleswig-Holstein;6 bis unter 10 Jahre;101763;52173;49590
01;  Schleswig-Holstein;10 bis unter 15 Jahre;146978;75274;71704
01;  Schleswig-Holstein;15 bis unter 18 Jahre;91150;46898;44252
01;  Schleswig-Holstein;18 bis unter 20 Jahre;63120;32243;30877
01;  Schleswig-Holstein;20 bis unter 25 Jahre;160790;82928;77862
01;  Schleswig-Holstein;25 bis unter 30 Jahre;148934;75117;73817
01;  Schleswig-Holstein;30 bis unter 35 Jahre;152685;75752;76933
01;  Schleswig-Holstein;35 bis unter 40 Jahre;160823;80595;80228
01;  Schleswig-Holstein;40 bis unter 45 Jahre;234615;119874;114741
01;  Schleswig-Holstein;45 bis unter 50 Jahre;251609;128038;123571
01;  Schleswig-Holstein;50 bis unter 55 Jahre;213455;105976;107479
01;  Schleswig-Holstein;55 bis unter 60 Jahre;180053;88591;91462
01;  Schleswig-Holstein;60 bis unter 65 Jahre;173379;84969;88410
01;  Schleswig-Holstein;65 bis unter 75 Jahre;346409;166086;180323
01;  Schleswig-Holstein;75 Jahre und mehr;272697;105752;166945
01;  Schleswig-Holstein;Insgesamt;2837641;1391708;1445933
01001;      Flensburg, Kreisfreie Stadt;unter 3 Jahre;2274;1129;1145
01001;      Flensburg, Kreisfreie Stadt;3 bis unter 6 Jahre;2138;1095;1043
01001;      Flensburg, Kreisfreie Stadt;6 bis unter 10 Jahre;2761;1397;1364
01001;      Flensburg, Kreisfreie Stadt;10 bis unter 15 Jahre;3816;1935;1881
01001;      Flensburg, Kreisfreie Stadt;15 bis unter 18 Jahre;2437;1228;1209
01001;      Flensburg, Kreisfreie Stadt;18 bis unter 20 Jahre;2019;968;1051
01001;      Flensburg, Kreisfreie Stadt;20 bis unter 25 Jahre;8474;4114;4360
01001;      Flensburg, Kreisfreie Stadt;25 bis unter 30 Jahre;7777;4074;3703
01001;      Flensburg, Kreisfreie Stadt;30 bis unter 35 Jahre;6134;3384;2750
01001;      Flensburg, Kreisfreie Stadt;35 bis unter 40 Jahre;5130;2729;2401
01001;      Flensburg, Kreisfreie Stadt;40 bis unter 45 Jahre;6361;3356;3005
01001;      Flensburg, Kreisfreie Stadt;45 bis unter 50 Jahre;6623;3469;3154
01001;      Flensburg, Kreisfreie Stadt;50 bis unter 55 Jahre;5857;2879;2978
01001;      Flensburg, Kreisfreie Stadt;55 bis unter 60 Jahre;5092;2484;2608
01001;      Flensburg, Kreisfreie Stadt;60 bis unter 65 Jahre;4867;2372;2495
01001;      Flensburg, Kreisfreie Stadt;65 bis unter 75 Jahre;9620;4519;5101
01001;      Flensburg, Kreisfreie Stadt;75 Jahre und mehr;7977;2896;5081
01001;      Flensburg, Kreisfreie Stadt;Insgesamt;89357;44028;45329
01002;      Kiel, Landeshauptstadt, Kreisfreie Stadt;unter 3 Jahre;6263;3224;3039
01002;      Kiel, Landeshauptstadt, Kreisfreie Stadt;3 bis unter 6 Jahre;5799;2951;2848
01002;      Kiel, Landeshauptstadt, Kreisfreie Stadt;6 bis unter 10 Jahre;7331;3822;3509
01002;      Kiel, Landeshauptstadt, Kreisfreie Stadt;10 bis unter 15 Jahre;9168;4732;4436
01002;      Kiel, Landeshauptstadt, Kreisfreie Stadt;15 bis unter 18 Jahre;5751;2880;2871
01002;      Kiel, Landeshauptstadt, Kreisfreie Stadt;18 bis unter 20 Jahre;5046;2495;2551
01002;      Kiel, Landeshauptstadt, Kreisfreie Stadt;20 bis unter 25 Jahre;21818;10106;11712
01002;      Kiel, Landeshauptstadt, Kreisfreie Stadt;25 bis unter 30 Jahre;22484;11238;11246
01002;      Kiel, Landeshauptstadt, Kreisfreie Stadt;30 bis unter 35 Jahre;17645;9153;8492
01002;      Kiel, Landeshauptstadt, Kreisfreie Stadt;35 bis unter 40 Jahre;14587;7534;7053
01002;      Kiel, Landeshauptstadt, Kreisfreie Stadt;40 bis unter 45 Jahre;17939;9509;8430
01002;      Kiel, Landeshauptstadt, Kreisfreie Stadt;45 bis unter 50 Jahre;20368;10529;9839
01002;      Kiel, Landeshauptstadt, Kreisfreie Stadt;50 bis unter 55 Jahre;17188;8907;8281
01002;      Kiel, Landeshauptstadt, Kreisfreie Stadt;55 bis unter 60 Jahre;14028;7000;7028
01002;      Kiel, Landeshauptstadt, Kreisfreie Stadt;60 bis unter 65 Jahre;12523;6158;6365
01002;      Kiel, Landeshauptstadt, Kreisfreie Stadt;65 bis unter 75 Jahre;24381;11460;12921
01002;      Kiel, Landeshauptstadt, Kreisfreie Stadt;75 Jahre und mehr;19722;7026;12696
01002;      Kiel, Landeshauptstadt, Kreisfreie Stadt;Insgesamt;242041;118724;123317
01003;      Lübeck, Hansestadt, Kreisfreie Stadt;unter 3 Jahre;5170;2589;2581
01003;      Lübeck, Hansestadt, Kreisfreie Stadt;3 bis unter 6 Jahre;5347;2689;2658
01003;      Lübeck, Hansestadt, Kreisfreie Stadt;6 bis unter 10 Jahre;6812;3454;3358
01003;      Lübeck, Hansestadt, Kreisfreie Stadt;10 bis unter 15 Jahre;9230;4659;4571
01003;      Lübeck, Hansestadt, Kreisfreie Stadt;15 bis unter 18 Jahre;5844;3026;2818
01003;      Lübeck, Hansestadt, Kreisfreie Stadt;18 bis unter 20 Jahre;4495;2195;2300
01003;      Lübeck, Hansestadt, Kreisfreie Stadt;20 bis unter 25 Jahre;14043;6876;7167
01003;      Lübeck, Hansestadt, Kreisfreie Stadt;25 bis unter 30 Jahre;13967;7054;6913
01003;      Lübeck, Hansestadt, Kreisfreie Stadt;30 bis unter 35 Jahre;12578;6245;6333
01003;      Lübeck, Hansestadt, Kreisfreie Stadt;35 bis unter 40 Jahre;11971;6079;5892
01003;      Lübeck, Hansestadt, Kreisfreie Stadt;40 bis unter 45 Jahre;15933;8097;7836
01003;      Lübeck, Hansestadt, Kreisfreie Stadt;45 bis unter 50 Jahre;16955;8496;8459
01003;      Lübeck, Hansestadt, Kreisfreie Stadt;50 bis unter 55 Jahre;14706;7194;7512
01003;      Lübeck, Hansestadt, Kreisfreie Stadt;55 bis unter 60 Jahre;12686;6020;6666
01003;      Lübeck, Hansestadt, Kreisfreie Stadt;60 bis unter 65 Jahre;12367;5865;6502
01003;      Lübeck, Hansestadt, Kreisfreie Stadt;65 bis unter 75 Jahre;25609;11639;13970
01003;      Lübeck, Hansestadt, Kreisfreie Stadt;75 Jahre und mehr;22864;8179;14685
01003;      Lübeck, Hansestadt, Kreisfreie Stadt;Insgesamt;210577;100356;110221
01004;      Neumünster, Kreisfreie Stadt;unter 3 Jahre;1964;1055;909
01004;      Neumünster, Kreisfreie Stadt;3 bis unter 6 Jahre;2083;1080;1003
01004;      Neumünster, Kreisfreie Stadt;6 bis unter 10 Jahre;2712;1407;1305
01004;      Neumünster, Kreisfreie Stadt;10 bis unter 15 Jahre;4066;2045;2021
01004;      Neumünster, Kreisfreie Stadt;15 bis unter 18 Jahre;2488;1291;1197
01004;      Neumünster, Kreisfreie Stadt;18 bis unter 20 Jahre;1917;988;929
01004;      Neumünster, Kreisfreie Stadt;20 bis unter 25 Jahre;5070;2673;2397
01004;      Neumünster, Kreisfreie Stadt;25 bis unter 30 Jahre;4408;2360;2048
01004;      Neumünster, Kreisfreie Stadt;30 bis unter 35 Jahre;4133;2162;1971
01004;      Neumünster, Kreisfreie Stadt;35 bis unter 40 Jahre;4325;2206;2119
01004;      Neumünster, Kreisfreie Stadt;40 bis unter 45 Jahre;5956;3059;2897
01004;      Neumünster, Kreisfreie Stadt;45 bis unter 50 Jahre;6184;3224;2960
01004;      Neumünster, Kreisfreie Stadt;50 bis unter 55 Jahre;5608;2763;2845
01004;      Neumünster, Kreisfreie Stadt;55 bis unter 60 Jahre;4754;2311;2443
01004;      Neumünster, Kreisfreie Stadt;60 bis unter 65 Jahre;4493;2189;2304
01004;      Neumünster, Kreisfreie Stadt;65 bis unter 75 Jahre;9253;4380;4873
01004;      Neumünster, Kreisfreie Stadt;75 Jahre und mehr;7525;2760;4765
01004;      Neumünster, Kreisfreie Stadt;Insgesamt;76939;37953;38986
01051;      Dithmarschen, Landkreis;unter 3 Jahre;3060;1568;1492
01051;      Dithmarschen, Landkreis;3 bis unter 6 Jahre;3216;1645;1571
01051;      Dithmarschen, Landkreis;6 bis unter 10 Jahre;4864;2450;2414
01051;      Dithmarschen, Landkreis;10 bis unter 15 Jahre;7450;3772;3678
01051;      Dithmarschen, Landkreis;15 bis unter 18 Jahre;4841;2513;2328
01051;      Dithmarschen, Landkreis;18 bis unter 20 Jahre;3226;1701;1525
01051;      Dithmarschen, Landkreis;20 bis unter 25 Jahre;7139;3760;3379
01051;      Dithmarschen, Landkreis;25 bis unter 30 Jahre;6343;3312;3031
01051;      Dithmarschen, Landkreis;30 bis unter 35 Jahre;6376;3112;3264
01051;      Dithmarschen, Landkreis;35 bis unter 40 Jahre;7021;3580;3441
01051;      Dithmarschen, Landkreis;40 bis unter 45 Jahre;10532;5365;5167
01051;      Dithmarschen, Landkreis;45 bis unter 50 Jahre;11050;5634;5416
01051;      Dithmarschen, Landkreis;50 bis unter 55 Jahre;10094;4976;5118
01051;      Dithmarschen, Landkreis;55 bis unter 60 Jahre;8928;4426;4502
01051;      Dithmarschen, Landkreis;60 bis unter 65 Jahre;8721;4295;4426
01051;      Dithmarschen, Landkreis;65 bis unter 75 Jahre;17056;8378;8678
01051;      Dithmarschen, Landkreis;75 Jahre und mehr;14151;5566;8585
01051;      Dithmarschen, Landkreis;Insgesamt;134068;66053;68015
01053;      Herzogtum Lauenburg, Landkreis;unter 3 Jahre;4441;2328;2113
01053;      Herzogtum Lauenburg, Landkreis;3 bis unter 6 Jahre;5008;2550;2458
01053;      Herzogtum Lauenburg, Landkreis;6 bis unter 10 Jahre;7394;3801;3593
01053;      Herzogtum Lauenburg, Landkreis;10 bis unter 15 Jahre;10445;5435;5010
01053;      Herzogtum Lauenburg, Landkreis;15 bis unter 18 Jahre;6084;3130;2954
01053;      Herzogtum Lauenburg, Landkreis;18 bis unter 20 Jahre;4152;2157;1995
01053;      Herzogtum Lauenburg, Landkreis;20 bis unter 25 Jahre;9465;4938;4527
01053;      Herzogtum Lauenburg, Landkreis;25 bis unter 30 Jahre;8769;4385;4384
01053;      Herzogtum Lauenburg, Landkreis;30 bis unter 35 Jahre;9615;4587;5028
01053;      Herzogtum Lauenburg, Landkreis;35 bis unter 40 Jahre;10708;5176;5532
01053;      Herzogtum Lauenburg, Landkreis;40 bis unter 45 Jahre;15825;7847;7978
01053;      Herzogtum Lauenburg, Landkreis;45 bis unter 50 Jahre;17283;8741;8542
01053;      Herzogtum Lauenburg, Landkreis;50 bis unter 55 Jahre;14680;7293;7387
01053;      Herzogtum Lauenburg, Landkreis;55 bis unter 60 Jahre;11836;5893;5943
01053;      Herzogtum Lauenburg, Landkreis;60 bis unter 65 Jahre;11167;5455;5712
01053;      Herzogtum Lauenburg, Landkreis;65 bis unter 75 Jahre;22261;10708;11553
01053;      Herzogtum Lauenburg, Landkreis;75 Jahre und mehr;18276;7171;11105
01053;      Herzogtum Lauenburg, Landkreis;Insgesamt;187409;91595;95814
01054;      Nordfriesland, Landkreis;unter 3 Jahre;3526;1814;1712
01054;      Nordfriesland, Landkreis;3 bis unter 6 Jahre;4008;2066;1942
01054;      Nordfriesland, Landkreis;6 bis unter 10 Jahre;6146;3121;3025
01054;      Nordfriesland, Landkreis;10 bis unter 15 Jahre;9165;4627;4538
01054;      Nordfriesland, Landkreis;15 bis unter 18 Jahre;5811;3014;2797
01054;      Nordfriesland, Landkreis;18 bis unter 20 Jahre;3949;2020;1929
01054;      Nordfriesland, Landkreis;20 bis unter 25 Jahre;8958;4794;4164
01054;      Nordfriesland, Landkreis;25 bis unter 30 Jahre;8216;4175;4041
01054;      Nordfriesland, Landkreis;30 bis unter 35 Jahre;8515;4238;4277
01054;      Nordfriesland, Landkreis;35 bis unter 40 Jahre;9235;4655;4580
01054;      Nordfriesland, Landkreis;40 bis unter 45 Jahre;13347;6896;6451
01054;      Nordfriesland, Landkreis;45 bis unter 50 Jahre;14208;7184;7024
01054;      Nordfriesland, Landkreis;50 bis unter 55 Jahre;12055;5829;6226
01054;      Nordfriesland, Landkreis;55 bis unter 60 Jahre;10572;5128;5444
01054;      Nordfriesland, Landkreis;60 bis unter 65 Jahre;10383;4992;5391
01054;      Nordfriesland, Landkreis;65 bis unter 75 Jahre;20490;9857;10633
01054;      Nordfriesland, Landkreis;75 Jahre und mehr;16474;6419;10055
01054;      Nordfriesland, Landkreis;Insgesamt;165058;80829;84229
01055;      Ostholstein, Landkreis;unter 3 Jahre;4090;2060;2030
01055;      Ostholstein, Landkreis;3 bis unter 6 Jahre;4320;2223;2097
01055;      Ostholstein, Landkreis;6 bis unter 10 Jahre;6651;3413;3238
01055;      Ostholstein, Landkreis;10 bis unter 15 Jahre;9682;4962;4720
01055;      Ostholstein, Landkreis;15 bis unter 18 Jahre;6297;3249;3048
01055;      Ostholstein, Landkreis;18 bis unter 20 Jahre;4216;2222;1994
01055;      Ostholstein, Landkreis;20 bis unter 25 Jahre;9404;4969;4435
01055;      Ostholstein, Landkreis;25 bis unter 30 Jahre;8512;4293;4219
01055;      Ostholstein, Landkreis;30 bis unter 35 Jahre;9541;4608;4933
01055;      Ostholstein, Landkreis;35 bis unter 40 Jahre;10582;5118;5464
01055;      Ostholstein, Landkreis;40 bis unter 45 Jahre;16199;8073;8126
01055;      Ostholstein, Landkreis;45 bis unter 50 Jahre;17653;8776;8877
01055;      Ostholstein, Landkreis;50 bis unter 55 Jahre;15821;7689;8132
01055;      Ostholstein, Landkreis;55 bis unter 60 Jahre;14114;6821;7293
01055;      Ostholstein, Landkreis;60 bis unter 65 Jahre;13960;6950;7010
01055;      Ostholstein, Landkreis;65 bis unter 75 Jahre;29161;14058;15103
01055;      Ostholstein, Landkreis;75 Jahre und mehr;23605;9263;14342
01055;      Ostholstein, Landkreis;Insgesamt;203808;98747;105061
01056;      Pinneberg, Landkreis;unter 3 Jahre;7504;3840;3664
01056;      Pinneberg, Landkreis;3 bis unter 6 Jahre;8125;4159;3966
01056;      Pinneberg, Landkreis;6 bis unter 10 Jahre;11361;5878;5483
01056;      Pinneberg, Landkreis;10 bis unter 15 Jahre;15843;8167;7676
01056;      Pinneberg, Landkreis;15 bis unter 18 Jahre;9666;5008;4658
01056;      Pinneberg, Landkreis;18 bis unter 20 Jahre;6300;3299;3001
01056;      Pinneberg, Landkreis;20 bis unter 25 Jahre;15858;8435;7423
01056;      Pinneberg, Landkreis;25 bis unter 30 Jahre;14762;7350;7412
01056;      Pinneberg, Landkreis;30 bis unter 35 Jahre;16432;8047;8385
01056;      Pinneberg, Landkreis;35 bis unter 40 Jahre;17755;8848;8907
01056;      Pinneberg, Landkreis;40 bis unter 45 Jahre;26412;13407;13005
01056;      Pinneberg, Landkreis;45 bis unter 50 Jahre;28548;14516;14032
01056;      Pinneberg, Landkreis;50 bis unter 55 Jahre;23696;11857;11839
01056;      Pinneberg, Landkreis;55 bis unter 60 Jahre;18921;9342;9579
01056;      Pinneberg, Landkreis;60 bis unter 65 Jahre;18318;8810;9508
01056;      Pinneberg, Landkreis;65 bis unter 75 Jahre;37146;17649;19497
01056;      Pinneberg, Landkreis;75 Jahre und mehr;28455;11373;17082
01056;      Pinneberg, Landkreis;Insgesamt;305102;149985;155117
01057;      Plön, Landkreis;unter 3 Jahre;2688;1343;1345
01057;      Plön, Landkreis;3 bis unter 6 Jahre;3112;1574;1538
01057;      Plön, Landkreis;6 bis unter 10 Jahre;4516;2302;2214
01057;      Plön, Landkreis;10 bis unter 15 Jahre;6995;3609;3386
01057;      Plön, Landkreis;15 bis unter 18 Jahre;4497;2277;2220
01057;      Plön, Landkreis;18 bis unter 20 Jahre;2929;1479;1450
01057;      Plön, Landkreis;20 bis unter 25 Jahre;5890;3182;2708
01057;      Plön, Landkreis;25 bis unter 30 Jahre;5035;2486;2549
01057;      Plön, Landkreis;30 bis unter 35 Jahre;6071;3107;2964
01057;      Plön, Landkreis;35 bis unter 40 Jahre;7953;4351;3602
01057;      Plön, Landkreis;40 bis unter 45 Jahre;12637;7191;5446
01057;      Plön, Landkreis;45 bis unter 50 Jahre;12509;6651;5858
01057;      Plön, Landkreis;50 bis unter 55 Jahre;10213;5059;5154
01057;      Plön, Landkreis;55 bis unter 60 Jahre;8659;4249;4410
01057;      Plön, Landkreis;60 bis unter 65 Jahre;8681;4251;4430
01057;      Plön, Landkreis;65 bis unter 75 Jahre;17803;8605;9198
01057;      Plön, Landkreis;75 Jahre und mehr;13245;5239;8006
01057;      Plön, Landkreis;Insgesamt;133433;66955;66478
01058;      Rendsburg-Eckernförde, Landkreis;unter 3 Jahre;6258;3184;3074
01058;      Rendsburg-Eckernförde, Landkreis;3 bis unter 6 Jahre;7077;3597;3480
01058;      Rendsburg-Eckernförde, Landkreis;6 bis unter 10 Jahre;10388;5341;5047
01058;      Rendsburg-Eckernförde, Landkreis;10 bis unter 15 Jahre;15422;7986;7436
01058;      Rendsburg-Eckernförde, Landkreis;15 bis unter 18 Jahre;9515;4940;4575
01058;      Rendsburg-Eckernförde, Landkreis;18 bis unter 20 Jahre;6501;3321;3180
01058;      Rendsburg-Eckernförde, Landkreis;20 bis unter 25 Jahre;13412;7201;6211
01058;      Rendsburg-Eckernförde, Landkreis;25 bis unter 30 Jahre;11474;5793;5681
01058;      Rendsburg-Eckernförde, Landkreis;30 bis unter 35 Jahre;12919;6257;6662
01058;      Rendsburg-Eckernförde, Landkreis;35 bis unter 40 Jahre;15136;7432;7704
01058;      Rendsburg-Eckernförde, Landkreis;40 bis unter 45 Jahre;22950;11562;11388
01058;      Rendsburg-Eckernförde, Landkreis;45 bis unter 50 Jahre;24320;12111;12209
01058;      Rendsburg-Eckernförde, Landkreis;50 bis unter 55 Jahre;20686;10206;10480
01058;      Rendsburg-Eckernförde, Landkreis;55 bis unter 60 Jahre;17690;8787;8903
01058;      Rendsburg-Eckernförde, Landkreis;60 bis unter 65 Jahre;17145;8579;8566
01058;      Rendsburg-Eckernförde, Landkreis;65 bis unter 75 Jahre;33231;16204;17027
01058;      Rendsburg-Eckernförde, Landkreis;75 Jahre und mehr;24895;9873;15022
01058;      Rendsburg-Eckernförde, Landkreis;Insgesamt;269019;132374;136645
01059;      Schleswig-Flensburg, Landkreis;unter 3 Jahre;4693;2458;2235
01059;      Schleswig-Flensburg, Landkreis;3 bis unter 6 Jahre;5021;2645;2376
01059;      Schleswig-Flensburg, Landkreis;6 bis unter 10 Jahre;7378;3730;3648
01059;      Schleswig-Flensburg, Landkreis;10 bis unter 15 Jahre;11403;5858;5545
01059;      Schleswig-Flensburg, Landkreis;15 bis unter 18 Jahre;7243;3686;3557
01059;      Schleswig-Flensburg, Landkreis;18 bis unter 20 Jahre;4938;2533;2405
01059;      Schleswig-Flensburg, Landkreis;20 bis unter 25 Jahre;10029;5436;4593
01059;      Schleswig-Flensburg, Landkreis;25 bis unter 30 Jahre;8543;4344;4199
01059;      Schleswig-Flensburg, Landkreis;30 bis unter 35 Jahre;9711;4825;4886
01059;      Schleswig-Flensburg, Landkreis;35 bis unter 40 Jahre;10872;5472;5400
01059;      Schleswig-Flensburg, Landkreis;40 bis unter 45 Jahre;16409;8406;8003
01059;      Schleswig-Flensburg, Landkreis;45 bis unter 50 Jahre;17708;9194;8514
01059;      Schleswig-Flensburg, Landkreis;50 bis unter 55 Jahre;14833;7449;7384
01059;      Schleswig-Flensburg, Landkreis;55 bis unter 60 Jahre;12828;6367;6461
01059;      Schleswig-Flensburg, Landkreis;60 bis unter 65 Jahre;12484;6227;6257
01059;      Schleswig-Flensburg, Landkreis;65 bis unter 75 Jahre;24660;12176;12484
01059;      Schleswig-Flensburg, Landkreis;75 Jahre und mehr;18605;7359;11246
01059;      Schleswig-Flensburg, Landkreis;Insgesamt;197358;98165;99193
01060;      Segeberg, Landkreis;unter 3 Jahre;6508;3410;3098
01060;      Segeberg, Landkreis;3 bis unter 6 Jahre;6976;3682;3294
01060;      Segeberg, Landkreis;6 bis unter 10 Jahre;9939;5117;4822
01060;      Segeberg, Landkreis;10 bis unter 15 Jahre;14249;7266;6983
01060;      Segeberg, Landkreis;15 bis unter 18 Jahre;8530;4363;4167
01060;      Segeberg, Landkreis;18 bis unter 20 Jahre;5507;2822;2685
01060;      Segeberg, Landkreis;20 bis unter 25 Jahre;13389;6950;6439
01060;      Segeberg, Landkreis;25 bis unter 30 Jahre;12800;6374;6426
01060;      Segeberg, Landkreis;30 bis unter 35 Jahre;14611;7098;7513
01060;      Segeberg, Landkreis;35 bis unter 40 Jahre;15322;7546;7776
01060;      Segeberg, Landkreis;40 bis unter 45 Jahre;22459;11282;11177
01060;      Segeberg, Landkreis;45 bis unter 50 Jahre;24127;12283;11844
01060;      Segeberg, Landkreis;50 bis unter 55 Jahre;19951;9845;10106
01060;      Segeberg, Landkreis;55 bis unter 60 Jahre;16643;8164;8479
01060;      Segeberg, Landkreis;60 bis unter 65 Jahre;15953;7781;8172
01060;      Segeberg, Landkreis;65 bis unter 75 Jahre;31118;14968;16150
01060;      Segeberg, Landkreis;75 Jahre und mehr;22024;8866;13158
01060;      Segeberg, Landkreis;Insgesamt;260106;127817;132289
01061;      Steinburg, Landkreis;unter 3 Jahre;3000;1544;1456
01061;      Steinburg, Landkreis;3 bis unter 6 Jahre;3218;1635;1583
01061;      Steinburg, Landkreis;6 bis unter 10 Jahre;4792;2438;2354
01061;      Steinburg, Landkreis;10 bis unter 15 Jahre;7364;3768;3596
01061;      Steinburg, Landkreis;15 bis unter 18 Jahre;4749;2441;2308
01061;      Steinburg, Landkreis;18 bis unter 20 Jahre;3209;1636;1573
01061;      Steinburg, Landkreis;20 bis unter 25 Jahre;7234;3905;3329
01061;      Steinburg, Landkreis;25 bis unter 30 Jahre;5859;3016;2843
01061;      Steinburg, Landkreis;30 bis unter 35 Jahre;6301;3119;3182
01061;      Steinburg, Landkreis;35 bis unter 40 Jahre;7168;3574;3594
01061;      Steinburg, Landkreis;40 bis unter 45 Jahre;11611;5974;5637
01061;      Steinburg, Landkreis;45 bis unter 50 Jahre;12576;6491;6085
01061;      Steinburg, Landkreis;50 bis unter 55 Jahre;10477;5293;5184
01061;      Steinburg, Landkreis;55 bis unter 60 Jahre;8398;4275;4123
01061;      Steinburg, Landkreis;60 bis unter 65 Jahre;8022;4009;4013
01061;      Steinburg, Landkreis;65 bis unter 75 Jahre;15836;7608;8228
01061;      Steinburg, Landkreis;75 Jahre und mehr;12460;4853;7607
01061;      Steinburg, Landkreis;Insgesamt;132274;65579;66695
01062;      Stormarn, Landkreis;unter 3 Jahre;5939;3042;2897
01062;      Stormarn, Landkreis;3 bis unter 6 Jahre;6355;3263;3092
01062;      Stormarn, Landkreis;6 bis unter 10 Jahre;8718;4502;4216
01062;      Stormarn, Landkreis;10 bis unter 15 Jahre;12680;6453;6227
01062;      Stormarn, Landkreis;15 bis unter 18 Jahre;7397;3852;3545
01062;      Stormarn, Landkreis;18 bis unter 20 Jahre;4716;2407;2309
01062;      Stormarn, Landkreis;20 bis unter 25 Jahre;10607;5589;5018
01062;      Stormarn, Landkreis;25 bis unter 30 Jahre;9985;4863;5122
01062;      Stormarn, Landkreis;30 bis unter 35 Jahre;12103;5810;6293
01062;      Stormarn, Landkreis;35 bis unter 40 Jahre;13058;6295;6763
01062;      Stormarn, Landkreis;40 bis unter 45 Jahre;20045;9850;10195
01062;      Stormarn, Landkreis;45 bis unter 50 Jahre;21497;10739;10758
01062;      Stormarn, Landkreis;50 bis unter 55 Jahre;17590;8737;8853
01062;      Stormarn, Landkreis;55 bis unter 60 Jahre;14904;7324;7580
01062;      Stormarn, Landkreis;60 bis unter 65 Jahre;14295;7036;7259
01062;      Stormarn, Landkreis;65 bis unter 75 Jahre;28784;13877;14907
01062;      Stormarn, Landkreis;75 Jahre und mehr;22419;8909;13510
01062;      Stormarn, Landkreis;Insgesamt;231092;112548;118544
02000;  Hamburg;unter 3 Jahre;49537;25446;24091
02000;  Hamburg;3 bis unter 6 Jahre;47397;24443;22954
02000;  Hamburg;6 bis unter 10 Jahre;59234;30300;28934
02000;  Hamburg;10 bis unter 15 Jahre;73702;37776;35926
02000;  Hamburg;15 bis unter 18 Jahre;45363;23500;21863
02000;  Hamburg;18 bis unter 20 Jahre;32987;16530;16457
02000;  Hamburg;20 bis unter 25 Jahre;114337;55319;59018
02000;  Hamburg;25 bis unter 30 Jahre;140993;68091;72902
02000;  Hamburg;30 bis unter 35 Jahre;147069;73556;73513
02000;  Hamburg;35 bis unter 40 Jahre;132522;68918;63604
02000;  Hamburg;40 bis unter 45 Jahre;150709;79524;71185
02000;  Hamburg;45 bis unter 50 Jahre;152934;79853;73081
02000;  Hamburg;50 bis unter 55 Jahre;122840;62183;60657
02000;  Hamburg;55 bis unter 60 Jahre;98385;48278;50107
02000;  Hamburg;60 bis unter 65 Jahre;93491;44767;48724
02000;  Hamburg;65 bis unter 75 Jahre;183086;85828;97258
02000;  Hamburg;75 Jahre und mehr;154250;56660;97590
02000;  Hamburg;Insgesamt;1798836;880972;917864
03;  Niedersachsen;unter 3 Jahre;188974;97156;91818
03;  Niedersachsen;3 bis unter 6 Jahre;199562;102705;96857
03;  Niedersachsen;6 bis unter 10 Jahre;287609;147193;140416
03;  Niedersachsen;10 bis unter 15 Jahre;419456;215161;204295
03;  Niedersachsen;15 bis unter 18 Jahre;261588;134086;127502
03;  Niedersachsen;18 bis unter 20 Jahre;181162;93503;87659
03;  Niedersachsen;20 bis unter 25 Jahre;463014;239786;223228
03;  Niedersachsen;25 bis unter 30 Jahre;437864;224155;213709
03;  Niedersachsen;30 bis unter 35 Jahre;438634;220911;217723
03;  Niedersachsen;35 bis unter 40 Jahre;453366;227678;225688
03;  Niedersachsen;40 bis unter 45 Jahre;626636;316426;310210
03;  Niedersachsen;45 bis unter 50 Jahre;689298;351577;337721
03;  Niedersachsen;50 bis unter 55 Jahre;612146;308630;303516
03;  Niedersachsen;55 bis unter 60 Jahre;522077;260261;261816
03;  Niedersachsen;60 bis unter 65 Jahre;477781;237424;240357
03;  Niedersachsen;65 bis unter 75 Jahre;885784;424221;461563
03;  Niedersachsen;75 Jahre und mehr;768551;295048;473503
03;  Niedersachsen;Insgesamt;7913502;3895921;4017581
031;    Braunschweig, Stat. Region;unter 3 Jahre;36197;18568;17629
031;    Braunschweig, Stat. Region;3 bis unter 6 Jahre;38033;19739;18294
031;    Braunschweig, Stat. Region;6 bis unter 10 Jahre;53271;27312;25959
031;    Braunschweig, Stat. Region;10 bis unter 15 Jahre;77668;39932;37736
031;    Braunschweig, Stat. Region;15 bis unter 18 Jahre;49269;25075;24194
031;    Braunschweig, Stat. Region;18 bis unter 20 Jahre;35220;18389;16831
031;    Braunschweig, Stat. Region;20 bis unter 25 Jahre;97401;50863;46538
031;    Braunschweig, Stat. Region;25 bis unter 30 Jahre;92897;48064;44833
031;    Braunschweig, Stat. Region;30 bis unter 35 Jahre;90520;45903;44617
031;    Braunschweig, Stat. Region;35 bis unter 40 Jahre;89598;45082;44516
031;    Braunschweig, Stat. Region;40 bis unter 45 Jahre;122904;61981;60923
031;    Braunschweig, Stat. Region;45 bis unter 50 Jahre;138167;70703;67464
031;    Braunschweig, Stat. Region;50 bis unter 55 Jahre;126640;64369;62271
031;    Braunschweig, Stat. Region;55 bis unter 60 Jahre;108065;54110;53955
031;    Braunschweig, Stat. Region;60 bis unter 65 Jahre;97731;48529;49202
031;    Braunschweig, Stat. Region;65 bis unter 75 Jahre;184246;87877;96369
031;    Braunschweig, Stat. Region;75 Jahre und mehr;168153;63980;104173
031;    Braunschweig, Stat. Region;Insgesamt;1605980;790476;815504
03101;      Braunschweig, Kreisfreie Stadt;unter 3 Jahre;6318;3207;3111
03101;      Braunschweig, Kreisfreie Stadt;3 bis unter 6 Jahre;5982;3090;2892
03101;      Braunschweig, Kreisfreie Stadt;6 bis unter 10 Jahre;7546;3772;3774
03101;      Braunschweig, Kreisfreie Stadt;10 bis unter 15 Jahre;9920;5041;4879
03101;      Braunschweig, Kreisfreie Stadt;15 bis unter 18 Jahre;6167;3145;3022
03101;      Braunschweig, Kreisfreie Stadt;18 bis unter 20 Jahre;5030;2620;2410
03101;      Braunschweig, Kreisfreie Stadt;20 bis unter 25 Jahre;18343;9473;8870
03101;      Braunschweig, Kreisfreie Stadt;25 bis unter 30 Jahre;19450;10239;9211
03101;      Braunschweig, Kreisfreie Stadt;30 bis unter 35 Jahre;18082;9547;8535
03101;      Braunschweig, Kreisfreie Stadt;35 bis unter 40 Jahre;15721;8347;7374
03101;      Braunschweig, Kreisfreie Stadt;40 bis unter 45 Jahre;19292;10240;9052
03101;      Braunschweig, Kreisfreie Stadt;45 bis unter 50 Jahre;20057;10484;9573
03101;      Braunschweig, Kreisfreie Stadt;50 bis unter 55 Jahre;17776;9013;8763
03101;      Braunschweig, Kreisfreie Stadt;55 bis unter 60 Jahre;14986;7350;7636
03101;      Braunschweig, Kreisfreie Stadt;60 bis unter 65 Jahre;13666;6581;7085
03101;      Braunschweig, Kreisfreie Stadt;65 bis unter 75 Jahre;27291;12766;14525
03101;      Braunschweig, Kreisfreie Stadt;75 Jahre und mehr;24929;9019;15910
03101;      Braunschweig, Kreisfreie Stadt;Insgesamt;250556;123934;126622
03102;      Salzgitter, Kreisfreie Stadt;unter 3 Jahre;2371;1247;1124
03102;      Salzgitter, Kreisfreie Stadt;3 bis unter 6 Jahre;2535;1348;1187
03102;      Salzgitter, Kreisfreie Stadt;6 bis unter 10 Jahre;3456;1791;1665
03102;      Salzgitter, Kreisfreie Stadt;10 bis unter 15 Jahre;5095;2622;2473
03102;      Salzgitter, Kreisfreie Stadt;15 bis unter 18 Jahre;3282;1679;1603
03102;      Salzgitter, Kreisfreie Stadt;18 bis unter 20 Jahre;2237;1140;1097
03102;      Salzgitter, Kreisfreie Stadt;20 bis unter 25 Jahre;5946;3111;2835
03102;      Salzgitter, Kreisfreie Stadt;25 bis unter 30 Jahre;5198;2686;2512
03102;      Salzgitter, Kreisfreie Stadt;30 bis unter 35 Jahre;5194;2673;2521
03102;      Salzgitter, Kreisfreie Stadt;35 bis unter 40 Jahre;5294;2667;2627
03102;      Salzgitter, Kreisfreie Stadt;40 bis unter 45 Jahre;7182;3529;3653
03102;      Salzgitter, Kreisfreie Stadt;45 bis unter 50 Jahre;8478;4293;4185
03102;      Salzgitter, Kreisfreie Stadt;50 bis unter 55 Jahre;7856;4008;3848
03102;      Salzgitter, Kreisfreie Stadt;55 bis unter 60 Jahre;7086;3535;3551
03102;      Salzgitter, Kreisfreie Stadt;60 bis unter 65 Jahre;6644;3230;3414
03102;      Salzgitter, Kreisfreie Stadt;65 bis unter 75 Jahre;12521;5990;6531
03102;      Salzgitter, Kreisfreie Stadt;75 Jahre und mehr;11375;4386;6989
03102;      Salzgitter, Kreisfreie Stadt;Insgesamt;101750;49935;51815
03103;      Wolfsburg, Kreisfreie Stadt;unter 3 Jahre;3135;1630;1505
03103;      Wolfsburg, Kreisfreie Stadt;3 bis unter 6 Jahre;3028;1546;1482
03103;      Wolfsburg, Kreisfreie Stadt;6 bis unter 10 Jahre;3997;2055;1942
03103;      Wolfsburg, Kreisfreie Stadt;10 bis unter 15 Jahre;5226;2665;2561
03103;      Wolfsburg, Kreisfreie Stadt;15 bis unter 18 Jahre;3313;1735;1578
03103;      Wolfsburg, Kreisfreie Stadt;18 bis unter 20 Jahre;2434;1236;1198
03103;      Wolfsburg, Kreisfreie Stadt;20 bis unter 25 Jahre;7529;3921;3608
03103;      Wolfsburg, Kreisfreie Stadt;25 bis unter 30 Jahre;8424;4376;4048
03103;      Wolfsburg, Kreisfreie Stadt;30 bis unter 35 Jahre;7943;4160;3783
03103;      Wolfsburg, Kreisfreie Stadt;35 bis unter 40 Jahre;6909;3554;3355
03103;      Wolfsburg, Kreisfreie Stadt;40 bis unter 45 Jahre;8794;4393;4401
03103;      Wolfsburg, Kreisfreie Stadt;45 bis unter 50 Jahre;9413;4829;4584
03103;      Wolfsburg, Kreisfreie Stadt;50 bis unter 55 Jahre;8847;4446;4401
03103;      Wolfsburg, Kreisfreie Stadt;55 bis unter 60 Jahre;8021;3936;4085
03103;      Wolfsburg, Kreisfreie Stadt;60 bis unter 65 Jahre;7102;3556;3546
03103;      Wolfsburg, Kreisfreie Stadt;65 bis unter 75 Jahre;14734;6821;7913
03103;      Wolfsburg, Kreisfreie Stadt;75 Jahre und mehr;13734;5511;8223
03103;      Wolfsburg, Kreisfreie Stadt;Insgesamt;122583;60370;62213
03151;      Gifhorn, Landkreis;unter 3 Jahre;4217;2170;2047
03151;      Gifhorn, Landkreis;3 bis unter 6 Jahre;4700;2412;2288
03151;      Gifhorn, Landkreis;6 bis unter 10 Jahre;6821;3461;3360
03151;      Gifhorn, Landkreis;10 bis unter 15 Jahre;9985;5140;4845
03151;      Gifhorn, Landkreis;15 bis unter 18 Jahre;6438;3256;3182
03151;      Gifhorn, Landkreis;18 bis unter 20 Jahre;4416;2341;2075
03151;      Gifhorn, Landkreis;20 bis unter 25 Jahre;9559;5097;4462
03151;      Gifhorn, Landkreis;25 bis unter 30 Jahre;8448;4321;4127
03151;      Gifhorn, Landkreis;30 bis unter 35 Jahre;9056;4398;4658
03151;      Gifhorn, Landkreis;35 bis unter 40 Jahre;9804;4814;4990
03151;      Gifhorn, Landkreis;40 bis unter 45 Jahre;13838;6938;6900
03151;      Gifhorn, Landkreis;45 bis unter 50 Jahre;16284;8329;7955
03151;      Gifhorn, Landkreis;50 bis unter 55 Jahre;14671;7519;7152
03151;      Gifhorn, Landkreis;55 bis unter 60 Jahre;11952;6117;5835
03151;      Gifhorn, Landkreis;60 bis unter 65 Jahre;10011;5108;4903
03151;      Gifhorn, Landkreis;65 bis unter 75 Jahre;17437;8609;8828
03151;      Gifhorn, Landkreis;75 Jahre und mehr;14373;5722;8651
03151;      Gifhorn, Landkreis;Insgesamt;172010;85752;86258
03152;      Göttingen, Landkreis;unter 3 Jahre;5839;3022;2817
03152;      Göttingen, Landkreis;3 bis unter 6 Jahre;5945;3057;2888
03152;      Göttingen, Landkreis;6 bis unter 10 Jahre;8300;4241;4059
03152;      Göttingen, Landkreis;10 bis unter 15 Jahre;11595;5909;5686
03152;      Göttingen, Landkreis;15 bis unter 18 Jahre;7486;3742;3744
03152;      Göttingen, Landkreis;18 bis unter 20 Jahre;5725;2938;2787
03152;      Göttingen, Landkreis;20 bis unter 25 Jahre;19572;9436;10136
03152;      Göttingen, Landkreis;25 bis unter 30 Jahre;19217;9666;9551
03152;      Göttingen, Landkreis;30 bis unter 35 Jahre;16403;8242;8161
03152;      Göttingen, Landkreis;35 bis unter 40 Jahre;14889;7514;7375
03152;      Göttingen, Landkreis;40 bis unter 45 Jahre;18667;9337;9330
03152;      Göttingen, Landkreis;45 bis unter 50 Jahre;22189;10994;11195
03152;      Göttingen, Landkreis;50 bis unter 55 Jahre;21181;10766;10415
03152;      Göttingen, Landkreis;55 bis unter 60 Jahre;16847;8566;8281
03152;      Göttingen, Landkreis;60 bis unter 65 Jahre;14659;7281;7378
03152;      Göttingen, Landkreis;65 bis unter 75 Jahre;26221;12441;13780
03152;      Göttingen, Landkreis;75 Jahre und mehr;23431;8987;14444
03152;      Göttingen, Landkreis;Insgesamt;258166;126139;132027
03153;      Goslar, Landkreis;unter 3 Jahre;2524;1292;1232
03153;      Goslar, Landkreis;3 bis unter 6 Jahre;2803;1460;1343
03153;      Goslar, Landkreis;6 bis unter 10 Jahre;4040;2054;1986
03153;      Goslar, Landkreis;10 bis unter 15 Jahre;6344;3278;3066
03153;      Goslar, Landkreis;15 bis unter 18 Jahre;4080;2152;1928
03153;      Goslar, Landkreis;18 bis unter 20 Jahre;2990;1649;1341
03153;      Goslar, Landkreis;20 bis unter 25 Jahre;7945;4583;3362
03153;      Goslar, Landkreis;25 bis unter 30 Jahre;6966;3707;3259
03153;      Goslar, Landkreis;30 bis unter 35 Jahre;6591;3415;3176
03153;      Goslar, Landkreis;35 bis unter 40 Jahre;7021;3464;3557
03153;      Goslar, Landkreis;40 bis unter 45 Jahre;10612;5377;5235
03153;      Goslar, Landkreis;45 bis unter 50 Jahre;12383;6614;5769
03153;      Goslar, Landkreis;50 bis unter 55 Jahre;11128;5754;5374
03153;      Goslar, Landkreis;55 bis unter 60 Jahre;9767;4869;4898
03153;      Goslar, Landkreis;60 bis unter 65 Jahre;9438;4622;4816
03153;      Goslar, Landkreis;65 bis unter 75 Jahre;19027;8948;10079
03153;      Goslar, Landkreis;75 Jahre und mehr;18452;6915;11537
03153;      Goslar, Landkreis;Insgesamt;142111;70153;71958
03154;      Helmstedt, Landkreis;unter 3 Jahre;1833;904;929
03154;      Helmstedt, Landkreis;3 bis unter 6 Jahre;2117;1115;1002
03154;      Helmstedt, Landkreis;6 bis unter 10 Jahre;2938;1528;1410
03154;      Helmstedt, Landkreis;10 bis unter 15 Jahre;4532;2368;2164
03154;      Helmstedt, Landkreis;15 bis unter 18 Jahre;2920;1491;1429
03154;      Helmstedt, Landkreis;18 bis unter 20 Jahre;2045;1112;933
03154;      Helmstedt, Landkreis;20 bis unter 25 Jahre;4905;2592;2313
03154;      Helmstedt, Landkreis;25 bis unter 30 Jahre;4320;2236;2084
03154;      Helmstedt, Landkreis;30 bis unter 35 Jahre;4781;2398;2383
03154;      Helmstedt, Landkreis;35 bis unter 40 Jahre;4882;2468;2414
03154;      Helmstedt, Landkreis;40 bis unter 45 Jahre;7229;3614;3615
03154;      Helmstedt, Landkreis;45 bis unter 50 Jahre;8150;4144;4006
03154;      Helmstedt, Landkreis;50 bis unter 55 Jahre;7672;3873;3799
03154;      Helmstedt, Landkreis;55 bis unter 60 Jahre;6697;3411;3286
03154;      Helmstedt, Landkreis;60 bis unter 65 Jahre;5985;3016;2969
03154;      Helmstedt, Landkreis;65 bis unter 75 Jahre;10844;5297;5547
03154;      Helmstedt, Landkreis;75 Jahre und mehr;10212;3806;6406
03154;      Helmstedt, Landkreis;Insgesamt;92062;45373;46689
03155;      Northeim, Landkreis;unter 3 Jahre;2850;1498;1352
03155;      Northeim, Landkreis;3 bis unter 6 Jahre;3086;1614;1472
03155;      Northeim, Landkreis;6 bis unter 10 Jahre;4567;2404;2163
03155;      Northeim, Landkreis;10 bis unter 15 Jahre;7135;3647;3488
03155;      Northeim, Landkreis;15 bis unter 18 Jahre;4403;2226;2177
03155;      Northeim, Landkreis;18 bis unter 20 Jahre;3063;1606;1457
03155;      Northeim, Landkreis;20 bis unter 25 Jahre;7058;3817;3241
03155;      Northeim, Landkreis;25 bis unter 30 Jahre;6241;3244;2997
03155;      Northeim, Landkreis;30 bis unter 35 Jahre;6599;3321;3278
03155;      Northeim, Landkreis;35 bis unter 40 Jahre;7235;3606;3629
03155;      Northeim, Landkreis;40 bis unter 45 Jahre;10416;5123;5293
03155;      Northeim, Landkreis;45 bis unter 50 Jahre;11872;5974;5898
03155;      Northeim, Landkreis;50 bis unter 55 Jahre;11259;5653;5606
03155;      Northeim, Landkreis;55 bis unter 60 Jahre;10006;5001;5005
03155;      Northeim, Landkreis;60 bis unter 65 Jahre;9091;4669;4422
03155;      Northeim, Landkreis;65 bis unter 75 Jahre;16487;7819;8668
03155;      Northeim, Landkreis;75 Jahre und mehr;16290;6232;10058
03155;      Northeim, Landkreis;Insgesamt;137658;67454;70204
03156;      Osterode am Harz, Landkreis;unter 3 Jahre;1413;737;676
03156;      Osterode am Harz, Landkreis;3 bis unter 6 Jahre;1597;840;757
03156;      Osterode am Harz, Landkreis;6 bis unter 10 Jahre;2308;1182;1126
03156;      Osterode am Harz, Landkreis;10 bis unter 15 Jahre;3698;1918;1780
03156;      Osterode am Harz, Landkreis;15 bis unter 18 Jahre;2362;1202;1160
03156;      Osterode am Harz, Landkreis;18 bis unter 20 Jahre;1590;818;772
03156;      Osterode am Harz, Landkreis;20 bis unter 25 Jahre;3585;1946;1639
03156;      Osterode am Harz, Landkreis;25 bis unter 30 Jahre;3341;1718;1623
03156;      Osterode am Harz, Landkreis;30 bis unter 35 Jahre;3369;1665;1704
03156;      Osterode am Harz, Landkreis;35 bis unter 40 Jahre;3835;1873;1962
03156;      Osterode am Harz, Landkreis;40 bis unter 45 Jahre;5740;2888;2852
03156;      Osterode am Harz, Landkreis;45 bis unter 50 Jahre;6097;3066;3031
03156;      Osterode am Harz, Landkreis;50 bis unter 55 Jahre;6005;3029;2976
03156;      Osterode am Harz, Landkreis;55 bis unter 60 Jahre;5491;2754;2737
03156;      Osterode am Harz, Landkreis;60 bis unter 65 Jahre;5448;2694;2754
03156;      Osterode am Harz, Landkreis;65 bis unter 75 Jahre;10284;4963;5321
03156;      Osterode am Harz, Landkreis;75 Jahre und mehr;10207;3810;6397
03156;      Osterode am Harz, Landkreis;Insgesamt;76370;37103;39267
03157;      Peine, Landkreis;unter 3 Jahre;3087;1549;1538
03157;      Peine, Landkreis;3 bis unter 6 Jahre;3399;1759;1640
03157;      Peine, Landkreis;6 bis unter 10 Jahre;5044;2608;2436
03157;      Peine, Landkreis;10 bis unter 15 Jahre;7588;3980;3608
03157;      Peine, Landkreis;15 bis unter 18 Jahre;4621;2356;2265
03157;      Peine, Landkreis;18 bis unter 20 Jahre;2992;1540;1452
03157;      Peine, Landkreis;20 bis unter 25 Jahre;6693;3590;3103
03157;      Peine, Landkreis;25 bis unter 30 Jahre;5947;3057;2890
03157;      Peine, Landkreis;30 bis unter 35 Jahre;6701;3270;3431
03157;      Peine, Landkreis;35 bis unter 40 Jahre;7539;3674;3865
03157;      Peine, Landkreis;40 bis unter 45 Jahre;11118;5573;5545
03157;      Peine, Landkreis;45 bis unter 50 Jahre;11981;6155;5826
03157;      Peine, Landkreis;50 bis unter 55 Jahre;10317;5307;5010
03157;      Peine, Landkreis;55 bis unter 60 Jahre;8842;4392;4450
03157;      Peine, Landkreis;60 bis unter 65 Jahre;7884;3898;3986
03157;      Peine, Landkreis;65 bis unter 75 Jahre;14550;7021;7529
03157;      Peine, Landkreis;75 Jahre und mehr;12772;4804;7968
03157;      Peine, Landkreis;Insgesamt;131075;64533;66542
03158;      Wolfenbüttel, Landkreis;unter 3 Jahre;2610;1312;1298
03158;      Wolfenbüttel, Landkreis;3 bis unter 6 Jahre;2841;1498;1343
03158;      Wolfenbüttel, Landkreis;6 bis unter 10 Jahre;4254;2216;2038
03158;      Wolfenbüttel, Landkreis;10 bis unter 15 Jahre;6550;3364;3186
03158;      Wolfenbüttel, Landkreis;15 bis unter 18 Jahre;4197;2091;2106
03158;      Wolfenbüttel, Landkreis;18 bis unter 20 Jahre;2698;1389;1309
03158;      Wolfenbüttel, Landkreis;20 bis unter 25 Jahre;6266;3297;2969
03158;      Wolfenbüttel, Landkreis;25 bis unter 30 Jahre;5345;2814;2531
03158;      Wolfenbüttel, Landkreis;30 bis unter 35 Jahre;5801;2814;2987
03158;      Wolfenbüttel, Landkreis;35 bis unter 40 Jahre;6469;3101;3368
03158;      Wolfenbüttel, Landkreis;40 bis unter 45 Jahre;10016;4969;5047
03158;      Wolfenbüttel, Landkreis;45 bis unter 50 Jahre;11263;5821;5442
03158;      Wolfenbüttel, Landkreis;50 bis unter 55 Jahre;9928;5001;4927
03158;      Wolfenbüttel, Landkreis;55 bis unter 60 Jahre;8370;4179;4191
03158;      Wolfenbüttel, Landkreis;60 bis unter 65 Jahre;7803;3874;3929
03158;      Wolfenbüttel, Landkreis;65 bis unter 75 Jahre;14850;7202;7648
03158;      Wolfenbüttel, Landkreis;75 Jahre und mehr;12378;4788;7590
03158;      Wolfenbüttel, Landkreis;Insgesamt;121639;59730;61909
032;    Hannover, Stat. Region;unter 3 Jahre;50664;25956;24708
032;    Hannover, Stat. Region;3 bis unter 6 Jahre;52917;27144;25773
032;    Hannover, Stat. Region;6 bis unter 10 Jahre;73916;37914;36002
032;    Hannover, Stat. Region;10 bis unter 15 Jahre;105880;54124;51756
032;    Hannover, Stat. Region;15 bis unter 18 Jahre;66206;34063;32143
032;    Hannover, Stat. Region;18 bis unter 20 Jahre;46197;23640;22557
032;    Hannover, Stat. Region;20 bis unter 25 Jahre;121666;61324;60342
032;    Hannover, Stat. Region;25 bis unter 30 Jahre;121044;60410;60634
032;    Hannover, Stat. Region;30 bis unter 35 Jahre;122500;60854;61646
032;    Hannover, Stat. Region;35 bis unter 40 Jahre;123415;61866;61549
032;    Hannover, Stat. Region;40 bis unter 45 Jahre;168119;84771;83348
032;    Hannover, Stat. Region;45 bis unter 50 Jahre;186449;94891;91558
032;    Hannover, Stat. Region;50 bis unter 55 Jahre;164553;82853;81700
032;    Hannover, Stat. Region;55 bis unter 60 Jahre;140786;69792;70994
032;    Hannover, Stat. Region;60 bis unter 65 Jahre;128250;62995;65255
032;    Hannover, Stat. Region;65 bis unter 75 Jahre;245359;116021;129338
032;    Hannover, Stat. Region;75 Jahre und mehr;219568;83575;135993
032;    Hannover, Stat. Region;Insgesamt;2137489;1042193;1095296
03241;      Region Hannover, Landkreis;unter 3 Jahre;28900;14796;14104
03241;      Region Hannover, Landkreis;3 bis unter 6 Jahre;29233;14974;14259
03241;      Region Hannover, Landkreis;6 bis unter 10 Jahre;38708;19830;18878
03241;      Region Hannover, Landkreis;10 bis unter 15 Jahre;52996;27091;25905
03241;      Region Hannover, Landkreis;15 bis unter 18 Jahre;32672;16779;15893
03241;      Region Hannover, Landkreis;18 bis unter 20 Jahre;22977;11732;11245
03241;      Region Hannover, Landkreis;20 bis unter 25 Jahre;66458;33023;33435
03241;      Region Hannover, Landkreis;25 bis unter 30 Jahre;72302;35402;36900
03241;      Region Hannover, Landkreis;30 bis unter 35 Jahre;73014;36191;36823
03241;      Region Hannover, Landkreis;35 bis unter 40 Jahre;70055;35295;34760
03241;      Region Hannover, Landkreis;40 bis unter 45 Jahre;89132;45348;43784
03241;      Region Hannover, Landkreis;45 bis unter 50 Jahre;98158;49807;48351
03241;      Region Hannover, Landkreis;50 bis unter 55 Jahre;85182;42877;42305
03241;      Region Hannover, Landkreis;55 bis unter 60 Jahre;72322;35487;36835
03241;      Region Hannover, Landkreis;60 bis unter 65 Jahre;65174;31566;33608
03241;      Region Hannover, Landkreis;65 bis unter 75 Jahre;127902;59921;67981
03241;      Region Hannover, Landkreis;75 Jahre und mehr;110782;42044;68738
03241;      Region Hannover, Landkreis;Insgesamt;1135967;552163;583804
03241001;      Hannover, Landeshauptstadt;unter 3 Jahre;14404;7418;6986
03241001;      Hannover, Landeshauptstadt;3 bis unter 6 Jahre;13506;6940;6566
03241001;      Hannover, Landeshauptstadt;6 bis unter 10 Jahre;16664;8567;8097
03241001;      Hannover, Landeshauptstadt;10 bis unter 15 Jahre;20968;10769;10199
03241001;      Hannover, Landeshauptstadt;15 bis unter 18 Jahre;12669;6562;6107
03241001;      Hannover, Landeshauptstadt;18 bis unter 20 Jahre;9532;4760;4772
03241001;      Hannover, Landeshauptstadt;20 bis unter 25 Jahre;35278;16767;18511
03241001;      Hannover, Landeshauptstadt;25 bis unter 30 Jahre;42769;20677;22092
03241001;      Hannover, Landeshauptstadt;30 bis unter 35 Jahre;40854;20507;20347
03241001;      Hannover, Landeshauptstadt;35 bis unter 40 Jahre;35777;18401;17376
03241001;      Hannover, Landeshauptstadt;40 bis unter 45 Jahre;40539;21141;19398
03241001;      Hannover, Landeshauptstadt;45 bis unter 50 Jahre;43840;22321;21519
03241001;      Hannover, Landeshauptstadt;50 bis unter 55 Jahre;37667;19087;18580
03241001;      Hannover, Landeshauptstadt;55 bis unter 60 Jahre;31212;15129;16083
03241001;      Hannover, Landeshauptstadt;60 bis unter 65 Jahre;27686;13270;14416
03241001;      Hannover, Landeshauptstadt;65 bis unter 75 Jahre;52349;24351;27998
03241001;      Hannover, Landeshauptstadt;75 Jahre und mehr;50161;18205;31956
03241001;      Hannover, Landeshauptstadt;Insgesamt;525875;254872;271003
03251;      Diepholz, Landkreis;unter 3 Jahre;4867;2514;2353
03251;      Diepholz, Landkreis;3 bis unter 6 Jahre;5320;2749;2571
03251;      Diepholz, Landkreis;6 bis unter 10 Jahre;7894;4094;3800
03251;      Diepholz, Landkreis;10 bis unter 15 Jahre;11894;6146;5748
03251;      Diepholz, Landkreis;15 bis unter 18 Jahre;7303;3721;3582
03251;      Diepholz, Landkreis;18 bis unter 20 Jahre;4957;2554;2403
03251;      Diepholz, Landkreis;20 bis unter 25 Jahre;11035;5857;5178
03251;      Diepholz, Landkreis;25 bis unter 30 Jahre;10205;5235;4970
03251;      Diepholz, Landkreis;30 bis unter 35 Jahre;10510;5188;5322
03251;      Diepholz, Landkreis;35 bis unter 40 Jahre;11936;5888;6048
03251;      Diepholz, Landkreis;40 bis unter 45 Jahre;17918;9006;8912
03251;      Diepholz, Landkreis;45 bis unter 50 Jahre;19361;10100;9261
03251;      Diepholz, Landkreis;50 bis unter 55 Jahre;17298;8756;8542
03251;      Diepholz, Landkreis;55 bis unter 60 Jahre;14616;7503;7113
03251;      Diepholz, Landkreis;60 bis unter 65 Jahre;13499;6822;6677
03251;      Diepholz, Landkreis;65 bis unter 75 Jahre;24321;11896;12425
03251;      Diepholz, Landkreis;75 Jahre und mehr;20459;8061;12398
03251;      Diepholz, Landkreis;Insgesamt;213393;106090;107303
03252;      Hameln-Pyrmont, Landkreis;unter 3 Jahre;3221;1642;1579
03252;      Hameln-Pyrmont, Landkreis;3 bis unter 6 Jahre;3484;1810;1674
03252;      Hameln-Pyrmont, Landkreis;6 bis unter 10 Jahre;5096;2561;2535
03252;      Hameln-Pyrmont, Landkreis;10 bis unter 15 Jahre;7568;3786;3782
03252;      Hameln-Pyrmont, Landkreis;15 bis unter 18 Jahre;4903;2545;2358
03252;      Hameln-Pyrmont, Landkreis;18 bis unter 20 Jahre;3620;1901;1719
03252;      Hameln-Pyrmont, Landkreis;20 bis unter 25 Jahre;8232;4356;3876
03252;      Hameln-Pyrmont, Landkreis;25 bis unter 30 Jahre;7268;3703;3565
03252;      Hameln-Pyrmont, Landkreis;30 bis unter 35 Jahre;7352;3672;3680
03252;      Hameln-Pyrmont, Landkreis;35 bis unter 40 Jahre;7727;3818;3909
03252;      Hameln-Pyrmont, Landkreis;40 bis unter 45 Jahre;11490;5705;5785
03252;      Hameln-Pyrmont, Landkreis;45 bis unter 50 Jahre;12959;6552;6407
03252;      Hameln-Pyrmont, Landkreis;50 bis unter 55 Jahre;11857;5836;6021
03252;      Hameln-Pyrmont, Landkreis;55 bis unter 60 Jahre;10695;5276;5419
03252;      Hameln-Pyrmont, Landkreis;60 bis unter 65 Jahre;9746;4781;4965
03252;      Hameln-Pyrmont, Landkreis;65 bis unter 75 Jahre;18944;8927;10017
03252;      Hameln-Pyrmont, Landkreis;75 Jahre und mehr;18520;6890;11630
03252;      Hameln-Pyrmont, Landkreis;Insgesamt;152682;73761;78921
03254;      Hildesheim, Landkreis;unter 3 Jahre;5979;3080;2899
03254;      Hildesheim, Landkreis;3 bis unter 6 Jahre;6572;3338;3234
03254;      Hildesheim, Landkreis;6 bis unter 10 Jahre;9753;5034;4719
03254;      Hildesheim, Landkreis;10 bis unter 15 Jahre;14392;7332;7060
03254;      Hildesheim, Landkreis;15 bis unter 18 Jahre;9137;4740;4397
03254;      Hildesheim, Landkreis;18 bis unter 20 Jahre;6463;3204;3259
03254;      Hildesheim, Landkreis;20 bis unter 25 Jahre;16965;8029;8936
03254;      Hildesheim, Landkreis;25 bis unter 30 Jahre;14417;7281;7136
03254;      Hildesheim, Landkreis;30 bis unter 35 Jahre;14335;7088;7247
03254;      Hildesheim, Landkreis;35 bis unter 40 Jahre;15241;7592;7649
03254;      Hildesheim, Landkreis;40 bis unter 45 Jahre;21618;10769;10849
03254;      Hildesheim, Landkreis;45 bis unter 50 Jahre;24610;12418;12192
03254;      Hildesheim, Landkreis;50 bis unter 55 Jahre;22135;11167;10968
03254;      Hildesheim, Landkreis;55 bis unter 60 Jahre;18761;9290;9471
03254;      Hildesheim, Landkreis;60 bis unter 65 Jahre;17529;8661;8868
03254;      Hildesheim, Landkreis;65 bis unter 75 Jahre;32692;15412;17280
03254;      Hildesheim, Landkreis;75 Jahre und mehr;30467;11588;18879
03254;      Hildesheim, Landkreis;Insgesamt;281066;136023;145043
03255;      Holzminden, Landkreis;unter 3 Jahre;1525;794;731
03255;      Holzminden, Landkreis;3 bis unter 6 Jahre;1565;809;756
03255;      Holzminden, Landkreis;6 bis unter 10 Jahre;2432;1261;1171
03255;      Holzminden, Landkreis;10 bis unter 15 Jahre;3741;1969;1772
03255;      Holzminden, Landkreis;15 bis unter 18 Jahre;2424;1225;1199
03255;      Holzminden, Landkreis;18 bis unter 20 Jahre;1584;811;773
03255;      Holzminden, Landkreis;20 bis unter 25 Jahre;3862;2055;1807
03255;      Holzminden, Landkreis;25 bis unter 30 Jahre;3547;1900;1647
03255;      Holzminden, Landkreis;30 bis unter 35 Jahre;3433;1723;1710
03255;      Holzminden, Landkreis;35 bis unter 40 Jahre;3543;1768;1775
03255;      Holzminden, Landkreis;40 bis unter 45 Jahre;5316;2656;2660
03255;      Holzminden, Landkreis;45 bis unter 50 Jahre;5878;3014;2864
03255;      Holzminden, Landkreis;50 bis unter 55 Jahre;5472;2729;2743
03255;      Holzminden, Landkreis;55 bis unter 60 Jahre;5118;2567;2551
03255;      Holzminden, Landkreis;60 bis unter 65 Jahre;4790;2404;2386
03255;      Holzminden, Landkreis;65 bis unter 75 Jahre;9190;4466;4724
03255;      Holzminden, Landkreis;75 Jahre und mehr;9003;3444;5559
03255;      Holzminden, Landkreis;Insgesamt;72423;35595;36828
03256;      Nienburg (Weser), Landkreis;unter 3 Jahre;2844;1445;1399
03256;      Nienburg (Weser), Landkreis;3 bis unter 6 Jahre;3029;1545;1484
03256;      Nienburg (Weser), Landkreis;6 bis unter 10 Jahre;4540;2319;2221
03256;      Nienburg (Weser), Landkreis;10 bis unter 15 Jahre;6728;3441;3287
03256;      Nienburg (Weser), Landkreis;15 bis unter 18 Jahre;4344;2281;2063
03256;      Nienburg (Weser), Landkreis;18 bis unter 20 Jahre;3035;1573;1462
03256;      Nienburg (Weser), Landkreis;20 bis unter 25 Jahre;7039;3738;3301
03256;      Nienburg (Weser), Landkreis;25 bis unter 30 Jahre;6023;3161;2862
03256;      Nienburg (Weser), Landkreis;30 bis unter 35 Jahre;6330;3234;3096
03256;      Nienburg (Weser), Landkreis;35 bis unter 40 Jahre;6701;3438;3263
03256;      Nienburg (Weser), Landkreis;40 bis unter 45 Jahre;9762;5012;4750
03256;      Nienburg (Weser), Landkreis;45 bis unter 50 Jahre;10764;5602;5162
03256;      Nienburg (Weser), Landkreis;50 bis unter 55 Jahre;9865;5066;4799
03256;      Nienburg (Weser), Landkreis;55 bis unter 60 Jahre;8457;4325;4132
03256;      Nienburg (Weser), Landkreis;60 bis unter 65 Jahre;7354;3735;3619
03256;      Nienburg (Weser), Landkreis;65 bis unter 75 Jahre;12965;6194;6771
03256;      Nienburg (Weser), Landkreis;75 Jahre und mehr;12445;4759;7686
03256;      Nienburg (Weser), Landkreis;Insgesamt;122225;60868;61357
03257;      Schaumburg, Landkreis;unter 3 Jahre;3328;1685;1643
03257;      Schaumburg, Landkreis;3 bis unter 6 Jahre;3714;1919;1795
03257;      Schaumburg, Landkreis;6 bis unter 10 Jahre;5493;2815;2678
03257;      Schaumburg, Landkreis;10 bis unter 15 Jahre;8561;4359;4202
03257;      Schaumburg, Landkreis;15 bis unter 18 Jahre;5423;2772;2651
03257;      Schaumburg, Landkreis;18 bis unter 20 Jahre;3561;1865;1696
03257;      Schaumburg, Landkreis;20 bis unter 25 Jahre;8075;4266;3809
03257;      Schaumburg, Landkreis;25 bis unter 30 Jahre;7282;3728;3554
03257;      Schaumburg, Landkreis;30 bis unter 35 Jahre;7526;3758;3768
03257;      Schaumburg, Landkreis;35 bis unter 40 Jahre;8212;4067;4145
03257;      Schaumburg, Landkreis;40 bis unter 45 Jahre;12883;6275;6608
03257;      Schaumburg, Landkreis;45 bis unter 50 Jahre;14719;7398;7321
03257;      Schaumburg, Landkreis;50 bis unter 55 Jahre;12744;6422;6322
03257;      Schaumburg, Landkreis;55 bis unter 60 Jahre;10817;5344;5473
03257;      Schaumburg, Landkreis;60 bis unter 65 Jahre;10158;5026;5132
03257;      Schaumburg, Landkreis;65 bis unter 75 Jahre;19345;9205;10140
03257;      Schaumburg, Landkreis;75 Jahre und mehr;17892;6789;11103
03257;      Schaumburg, Landkreis;Insgesamt;159733;77693;82040
033;    Lüneburg, Stat. Region;unter 3 Jahre;40405;20833;19572
033;    Lüneburg, Stat. Region;3 bis unter 6 Jahre;43377;22284;21093
033;    Lüneburg, Stat. Region;6 bis unter 10 Jahre;64052;32728;31324
033;    Lüneburg, Stat. Region;10 bis unter 15 Jahre;94130;48261;45869
033;    Lüneburg, Stat. Region;15 bis unter 18 Jahre;58194;30108;28086
033;    Lüneburg, Stat. Region;18 bis unter 20 Jahre;38385;19947;18438
033;    Lüneburg, Stat. Region;20 bis unter 25 Jahre;89815;47567;42248
033;    Lüneburg, Stat. Region;25 bis unter 30 Jahre;82116;41797;40319
033;    Lüneburg, Stat. Region;30 bis unter 35 Jahre;87815;43507;44308
033;    Lüneburg, Stat. Region;35 bis unter 40 Jahre;95273;47296;47977
033;    Lüneburg, Stat. Region;40 bis unter 45 Jahre;137313;69042;68271
033;    Lüneburg, Stat. Region;45 bis unter 50 Jahre;150327;76542;73785
033;    Lüneburg, Stat. Region;50 bis unter 55 Jahre;131571;65973;65598
033;    Lüneburg, Stat. Region;55 bis unter 60 Jahre;112785;56039;56746
033;    Lüneburg, Stat. Region;60 bis unter 65 Jahre;106368;53025;53343
033;    Lüneburg, Stat. Region;65 bis unter 75 Jahre;197479;95876;101603
033;    Lüneburg, Stat. Region;75 Jahre und mehr;160308;62572;97736
033;    Lüneburg, Stat. Region;Insgesamt;1689713;833397;856316
03351;      Celle, Landkreis;unter 3 Jahre;4318;2235;2083
03351;      Celle, Landkreis;3 bis unter 6 Jahre;4567;2331;2236
03351;      Celle, Landkreis;6 bis unter 10 Jahre;6852;3463;3389
03351;      Celle, Landkreis;10 bis unter 15 Jahre;9658;4959;4699
03351;      Celle, Landkreis;15 bis unter 18 Jahre;6054;3130;2924
03351;      Celle, Landkreis;18 bis unter 20 Jahre;4224;2132;2092
03351;      Celle, Landkreis;20 bis unter 25 Jahre;9697;5082;4615
03351;      Celle, Landkreis;25 bis unter 30 Jahre;8952;4496;4456
03351;      Celle, Landkreis;30 bis unter 35 Jahre;9457;4806;4651
03351;      Celle, Landkreis;35 bis unter 40 Jahre;9512;4633;4879
03351;      Celle, Landkreis;40 bis unter 45 Jahre;13193;6642;6551
03351;      Celle, Landkreis;45 bis unter 50 Jahre;14999;7822;7177
03351;      Celle, Landkreis;50 bis unter 55 Jahre;13349;6592;6757
03351;      Celle, Landkreis;55 bis unter 60 Jahre;12416;6105;6311
03351;      Celle, Landkreis;60 bis unter 65 Jahre;11156;5622;5534
03351;      Celle, Landkreis;65 bis unter 75 Jahre;20950;10034;10916
03351;      Celle, Landkreis;75 Jahre und mehr;18237;6896;11341
03351;      Celle, Landkreis;Insgesamt;177591;86980;90611
03352;      Cuxhaven, Landkreis;unter 3 Jahre;4377;2225;2152
03352;      Cuxhaven, Landkreis;3 bis unter 6 Jahre;4832;2527;2305
03352;      Cuxhaven, Landkreis;6 bis unter 10 Jahre;7144;3642;3502
03352;      Cuxhaven, Landkreis;10 bis unter 15 Jahre;10735;5481;5254
03352;      Cuxhaven, Landkreis;15 bis unter 18 Jahre;6901;3577;3324
03352;      Cuxhaven, Landkreis;18 bis unter 20 Jahre;4425;2417;2008
03352;      Cuxhaven, Landkreis;20 bis unter 25 Jahre;9816;5243;4573
03352;      Cuxhaven, Landkreis;25 bis unter 30 Jahre;8920;4560;4360
03352;      Cuxhaven, Landkreis;30 bis unter 35 Jahre;9423;4677;4746
03352;      Cuxhaven, Landkreis;35 bis unter 40 Jahre;10703;5229;5474
03352;      Cuxhaven, Landkreis;40 bis unter 45 Jahre;15632;7769;7863
03352;      Cuxhaven, Landkreis;45 bis unter 50 Jahre;16767;8362;8405
03352;      Cuxhaven, Landkreis;50 bis unter 55 Jahre;15283;7454;7829
03352;      Cuxhaven, Landkreis;55 bis unter 60 Jahre;14007;6920;7087
03352;      Cuxhaven, Landkreis;60 bis unter 65 Jahre;13955;6995;6960
03352;      Cuxhaven, Landkreis;65 bis unter 75 Jahre;25261;12494;12767
03352;      Cuxhaven, Landkreis;75 Jahre und mehr;21262;8335;12927
03352;      Cuxhaven, Landkreis;Insgesamt;199443;97907;101536
03353;      Harburg, Landkreis;unter 3 Jahre;6020;3069;2951
03353;      Harburg, Landkreis;3 bis unter 6 Jahre;6625;3406;3219
03353;      Harburg, Landkreis;6 bis unter 10 Jahre;9609;4939;4670
03353;      Harburg, Landkreis;10 bis unter 15 Jahre;13748;7099;6649
03353;      Harburg, Landkreis;15 bis unter 18 Jahre;8226;4224;4002
03353;      Harburg, Landkreis;18 bis unter 20 Jahre;5128;2684;2444
03353;      Harburg, Landkreis;20 bis unter 25 Jahre;11920;6309;5611
03353;      Harburg, Landkreis;25 bis unter 30 Jahre;10702;5357;5345
03353;      Harburg, Landkreis;30 bis unter 35 Jahre;12598;5994;6604
03353;      Harburg, Landkreis;35 bis unter 40 Jahre;13981;6715;7266
03353;      Harburg, Landkreis;40 bis unter 45 Jahre;21753;10728;11025
03353;      Harburg, Landkreis;45 bis unter 50 Jahre;23901;11942;11959
03353;      Harburg, Landkreis;50 bis unter 55 Jahre;19692;9962;9730
03353;      Harburg, Landkreis;55 bis unter 60 Jahre;15798;7937;7861
03353;      Harburg, Landkreis;60 bis unter 65 Jahre;15679;7587;8092
03353;      Harburg, Landkreis;65 bis unter 75 Jahre;30476;14807;15669
03353;      Harburg, Landkreis;75 Jahre und mehr;22133;9045;13088
03353;      Harburg, Landkreis;Insgesamt;247989;121804;126185
03354;      Lüchow-Dannenberg, Landkreis;unter 3 Jahre;936;491;445
03354;      Lüchow-Dannenberg, Landkreis;3 bis unter 6 Jahre;1038;565;473
03354;      Lüchow-Dannenberg, Landkreis;6 bis unter 10 Jahre;1712;875;837
03354;      Lüchow-Dannenberg, Landkreis;10 bis unter 15 Jahre;2473;1283;1190
03354;      Lüchow-Dannenberg, Landkreis;15 bis unter 18 Jahre;1633;812;821
03354;      Lüchow-Dannenberg, Landkreis;18 bis unter 20 Jahre;1060;563;497
03354;      Lüchow-Dannenberg, Landkreis;20 bis unter 25 Jahre;2331;1283;1048
03354;      Lüchow-Dannenberg, Landkreis;25 bis unter 30 Jahre;2070;1115;955
03354;      Lüchow-Dannenberg, Landkreis;30 bis unter 35 Jahre;2280;1144;1136
03354;      Lüchow-Dannenberg, Landkreis;35 bis unter 40 Jahre;2416;1226;1190
03354;      Lüchow-Dannenberg, Landkreis;40 bis unter 45 Jahre;3530;1805;1725
03354;      Lüchow-Dannenberg, Landkreis;45 bis unter 50 Jahre;3840;1933;1907
03354;      Lüchow-Dannenberg, Landkreis;50 bis unter 55 Jahre;3945;1957;1988
03354;      Lüchow-Dannenberg, Landkreis;55 bis unter 60 Jahre;3537;1732;1805
03354;      Lüchow-Dannenberg, Landkreis;60 bis unter 65 Jahre;3375;1679;1696
03354;      Lüchow-Dannenberg, Landkreis;65 bis unter 75 Jahre;6751;3280;3471
03354;      Lüchow-Dannenberg, Landkreis;75 Jahre und mehr;6090;2433;3657
03354;      Lüchow-Dannenberg, Landkreis;Insgesamt;49017;24176;24841
03355;      Lüneburg, Landkreis;unter 3 Jahre;4532;2295;2237
03355;      Lüneburg, Landkreis;3 bis unter 6 Jahre;4704;2395;2309
03355;      Lüneburg, Landkreis;6 bis unter 10 Jahre;6757;3408;3349
03355;      Lüneburg, Landkreis;10 bis unter 15 Jahre;9792;5055;4737
03355;      Lüneburg, Landkreis;15 bis unter 18 Jahre;5819;3035;2784
03355;      Lüneburg, Landkreis;18 bis unter 20 Jahre;3900;1984;1916
03355;      Lüneburg, Landkreis;20 bis unter 25 Jahre;10478;5133;5345
03355;      Lüneburg, Landkreis;25 bis unter 30 Jahre;10305;4990;5315
03355;      Lüneburg, Landkreis;30 bis unter 35 Jahre;10835;5315;5520
03355;      Lüneburg, Landkreis;35 bis unter 40 Jahre;11076;5537;5539
03355;      Lüneburg, Landkreis;40 bis unter 45 Jahre;15222;7689;7533
03355;      Lüneburg, Landkreis;45 bis unter 50 Jahre;16569;8426;8143
03355;      Lüneburg, Landkreis;50 bis unter 55 Jahre;13465;6834;6631
03355;      Lüneburg, Landkreis;55 bis unter 60 Jahre;11167;5566;5601
03355;      Lüneburg, Landkreis;60 bis unter 65 Jahre;10113;5054;5059
03355;      Lüneburg, Landkreis;65 bis unter 75 Jahre;18350;8841;9509
03355;      Lüneburg, Landkreis;75 Jahre und mehr;15006;5644;9362
03355;      Lüneburg, Landkreis;Insgesamt;178090;87201;90889
03356;      Osterholz, Landkreis;unter 3 Jahre;2519;1332;1187
03356;      Osterholz, Landkreis;3 bis unter 6 Jahre;2735;1387;1348
03356;      Osterholz, Landkreis;6 bis unter 10 Jahre;4145;2149;1996
03356;      Osterholz, Landkreis;10 bis unter 15 Jahre;6314;3287;3027
03356;      Osterholz, Landkreis;15 bis unter 18 Jahre;3834;1989;1845
03356;      Osterholz, Landkreis;18 bis unter 20 Jahre;2525;1287;1238
03356;      Osterholz, Landkreis;20 bis unter 25 Jahre;5420;2900;2520
03356;      Osterholz, Landkreis;25 bis unter 30 Jahre;4600;2345;2255
03356;      Osterholz, Landkreis;30 bis unter 35 Jahre;5427;2660;2767
03356;      Osterholz, Landkreis;35 bis unter 40 Jahre;6096;2966;3130
03356;      Osterholz, Landkreis;40 bis unter 45 Jahre;9538;4750;4788
03356;      Osterholz, Landkreis;45 bis unter 50 Jahre;10490;5273;5217
03356;      Osterholz, Landkreis;50 bis unter 55 Jahre;9230;4641;4589
03356;      Osterholz, Landkreis;55 bis unter 60 Jahre;7595;3745;3850
03356;      Osterholz, Landkreis;60 bis unter 65 Jahre;7321;3612;3709
03356;      Osterholz, Landkreis;65 bis unter 75 Jahre;13882;6720;7162
03356;      Osterholz, Landkreis;75 Jahre und mehr;10047;3967;6080
03356;      Osterholz, Landkreis;Insgesamt;111718;55010;56708
03357;      Rotenburg (Wümme), Landkreis;unter 3 Jahre;3931;2002;1929
03357;      Rotenburg (Wümme), Landkreis;3 bis unter 6 Jahre;4322;2196;2126
03357;      Rotenburg (Wümme), Landkreis;6 bis unter 10 Jahre;6544;3413;3131
03357;      Rotenburg (Wümme), Landkreis;10 bis unter 15 Jahre;9894;5125;4769
03357;      Rotenburg (Wümme), Landkreis;15 bis unter 18 Jahre;6002;3103;2899
03357;      Rotenburg (Wümme), Landkreis;18 bis unter 20 Jahre;4131;2134;1997
03357;      Rotenburg (Wümme), Landkreis;20 bis unter 25 Jahre;9574;5299;4275
03357;      Rotenburg (Wümme), Landkreis;25 bis unter 30 Jahre;8326;4343;3983
03357;      Rotenburg (Wümme), Landkreis;30 bis unter 35 Jahre;8468;4277;4191
03357;      Rotenburg (Wümme), Landkreis;35 bis unter 40 Jahre;9321;4706;4615
03357;      Rotenburg (Wümme), Landkreis;40 bis unter 45 Jahre;13412;6676;6736
03357;      Rotenburg (Wümme), Landkreis;45 bis unter 50 Jahre;14412;7565;6847
03357;      Rotenburg (Wümme), Landkreis;50 bis unter 55 Jahre;12503;6314;6189
03357;      Rotenburg (Wümme), Landkreis;55 bis unter 60 Jahre;10821;5418;5403
03357;      Rotenburg (Wümme), Landkreis;60 bis unter 65 Jahre;9813;5042;4771
03357;      Rotenburg (Wümme), Landkreis;65 bis unter 75 Jahre;17083;8433;8650
03357;      Rotenburg (Wümme), Landkreis;75 Jahre und mehr;14406;5671;8735
03357;      Rotenburg (Wümme), Landkreis;Insgesamt;162963;81717;81246
03358;      Soltau-Fallingbostel, Landkreis;unter 3 Jahre;3340;1755;1585
03358;      Soltau-Fallingbostel, Landkreis;3 bis unter 6 Jahre;3569;1885;1684
03358;      Soltau-Fallingbostel, Landkreis;6 bis unter 10 Jahre;5250;2701;2549
03358;      Soltau-Fallingbostel, Landkreis;10 bis unter 15 Jahre;7639;3863;3776
03358;      Soltau-Fallingbostel, Landkreis;15 bis unter 18 Jahre;4860;2556;2304
03358;      Soltau-Fallingbostel, Landkreis;18 bis unter 20 Jahre;3292;1751;1541
03358;      Soltau-Fallingbostel, Landkreis;20 bis unter 25 Jahre;7681;4225;3456
03358;      Soltau-Fallingbostel, Landkreis;25 bis unter 30 Jahre;7055;3632;3423
03358;      Soltau-Fallingbostel, Landkreis;30 bis unter 35 Jahre;7201;3506;3695
03358;      Soltau-Fallingbostel, Landkreis;35 bis unter 40 Jahre;7482;3874;3608
03358;      Soltau-Fallingbostel, Landkreis;40 bis unter 45 Jahre;11274;5791;5483
03358;      Soltau-Fallingbostel, Landkreis;45 bis unter 50 Jahre;12324;6441;5883
03358;      Soltau-Fallingbostel, Landkreis;50 bis unter 55 Jahre;10911;5590;5321
03358;      Soltau-Fallingbostel, Landkreis;55 bis unter 60 Jahre;9041;4536;4505
03358;      Soltau-Fallingbostel, Landkreis;60 bis unter 65 Jahre;8198;4153;4045
03358;      Soltau-Fallingbostel, Landkreis;65 bis unter 75 Jahre;15670;7567;8103
03358;      Soltau-Fallingbostel, Landkreis;75 Jahre und mehr;13997;5416;8581
03358;      Soltau-Fallingbostel, Landkreis;Insgesamt;138784;69242;69542
03359;      Stade, Landkreis;unter 3 Jahre;5126;2730;2396
03359;      Stade, Landkreis;3 bis unter 6 Jahre;5296;2704;2592
03359;      Stade, Landkreis;6 bis unter 10 Jahre;7650;3858;3792
03359;      Stade, Landkreis;10 bis unter 15 Jahre;11412;5771;5641
03359;      Stade, Landkreis;15 bis unter 18 Jahre;7060;3646;3414
03359;      Stade, Landkreis;18 bis unter 20 Jahre;4604;2409;2195
03359;      Stade, Landkreis;20 bis unter 25 Jahre;10896;5841;5055
03359;      Stade, Landkreis;25 bis unter 30 Jahre;10339;5384;4955
03359;      Stade, Landkreis;30 bis unter 35 Jahre;10984;5657;5327
03359;      Stade, Landkreis;35 bis unter 40 Jahre;12023;6174;5849
03359;      Stade, Landkreis;40 bis unter 45 Jahre;15863;8245;7618
03359;      Stade, Landkreis;45 bis unter 50 Jahre;17340;8922;8418
03359;      Stade, Landkreis;50 bis unter 55 Jahre;15168;7693;7475
03359;      Stade, Landkreis;55 bis unter 60 Jahre;12827;6338;6489
03359;      Stade, Landkreis;60 bis unter 65 Jahre;12183;5994;6189
03359;      Stade, Landkreis;65 bis unter 75 Jahre;22120;10698;11422
03359;      Stade, Landkreis;75 Jahre und mehr;16629;6462;10167
03359;      Stade, Landkreis;Insgesamt;197520;98526;98994
03360;      Uelzen, Landkreis;unter 3 Jahre;1976;1006;970
03360;      Uelzen, Landkreis;3 bis unter 6 Jahre;2209;1114;1095
03360;      Uelzen, Landkreis;6 bis unter 10 Jahre;3287;1699;1588
03360;      Uelzen, Landkreis;10 bis unter 15 Jahre;4880;2553;2327
03360;      Uelzen, Landkreis;15 bis unter 18 Jahre;3173;1625;1548
03360;      Uelzen, Landkreis;18 bis unter 20 Jahre;2050;1042;1008
03360;      Uelzen, Landkreis;20 bis unter 25 Jahre;4837;2496;2341
03360;      Uelzen, Landkreis;25 bis unter 30 Jahre;4184;2186;1998
03360;      Uelzen, Landkreis;30 bis unter 35 Jahre;4518;2245;2273
03360;      Uelzen, Landkreis;35 bis unter 40 Jahre;5217;2527;2690
03360;      Uelzen, Landkreis;40 bis unter 45 Jahre;7217;3620;3597
03360;      Uelzen, Landkreis;45 bis unter 50 Jahre;7853;3962;3891
03360;      Uelzen, Landkreis;50 bis unter 55 Jahre;7396;3676;3720
03360;      Uelzen, Landkreis;55 bis unter 60 Jahre;6358;3127;3231
03360;      Uelzen, Landkreis;60 bis unter 65 Jahre;5837;2937;2900
03360;      Uelzen, Landkreis;65 bis unter 75 Jahre;11666;5487;6179
03360;      Uelzen, Landkreis;75 Jahre und mehr;10906;4187;6719
03360;      Uelzen, Landkreis;Insgesamt;93564;45489;48075
03361;      Verden, Landkreis;unter 3 Jahre;3330;1693;1637
03361;      Verden, Landkreis;3 bis unter 6 Jahre;3480;1774;1706
03361;      Verden, Landkreis;6 bis unter 10 Jahre;5102;2581;2521
03361;      Verden, Landkreis;10 bis unter 15 Jahre;7585;3785;3800
03361;      Verden, Landkreis;15 bis unter 18 Jahre;4632;2411;2221
03361;      Verden, Landkreis;18 bis unter 20 Jahre;3046;1544;1502
03361;      Verden, Landkreis;20 bis unter 25 Jahre;7165;3756;3409
03361;      Verden, Landkreis;25 bis unter 30 Jahre;6663;3389;3274
03361;      Verden, Landkreis;30 bis unter 35 Jahre;6624;3226;3398
03361;      Verden, Landkreis;35 bis unter 40 Jahre;7446;3709;3737
03361;      Verden, Landkreis;40 bis unter 45 Jahre;10679;5327;5352
03361;      Verden, Landkreis;45 bis unter 50 Jahre;11832;5894;5938
03361;      Verden, Landkreis;50 bis unter 55 Jahre;10629;5260;5369
03361;      Verden, Landkreis;55 bis unter 60 Jahre;9218;4615;4603
03361;      Verden, Landkreis;60 bis unter 65 Jahre;8738;4350;4388
03361;      Verden, Landkreis;65 bis unter 75 Jahre;15270;7515;7755
03361;      Verden, Landkreis;75 Jahre und mehr;11595;4516;7079
03361;      Verden, Landkreis;Insgesamt;133034;65345;67689
034;    Weser-Ems, Stat. Region;unter 3 Jahre;61708;31799;29909
034;    Weser-Ems, Stat. Region;3 bis unter 6 Jahre;65235;33538;31697
034;    Weser-Ems, Stat. Region;6 bis unter 10 Jahre;96370;49239;47131
034;    Weser-Ems, Stat. Region;10 bis unter 15 Jahre;141778;72844;68934
034;    Weser-Ems, Stat. Region;15 bis unter 18 Jahre;87919;44840;43079
034;    Weser-Ems, Stat. Region;18 bis unter 20 Jahre;61360;31527;29833
034;    Weser-Ems, Stat. Region;20 bis unter 25 Jahre;154132;80032;74100
034;    Weser-Ems, Stat. Region;25 bis unter 30 Jahre;141807;73884;67923
034;    Weser-Ems, Stat. Region;30 bis unter 35 Jahre;137799;70647;67152
034;    Weser-Ems, Stat. Region;35 bis unter 40 Jahre;145080;73434;71646
034;    Weser-Ems, Stat. Region;40 bis unter 45 Jahre;198300;100632;97668
034;    Weser-Ems, Stat. Region;45 bis unter 50 Jahre;214355;109441;104914
034;    Weser-Ems, Stat. Region;50 bis unter 55 Jahre;189382;95435;93947
034;    Weser-Ems, Stat. Region;55 bis unter 60 Jahre;160441;80320;80121
034;    Weser-Ems, Stat. Region;60 bis unter 65 Jahre;145432;72875;72557
034;    Weser-Ems, Stat. Region;65 bis unter 75 Jahre;258700;124447;134253
034;    Weser-Ems, Stat. Region;75 Jahre und mehr;220522;84921;135601
034;    Weser-Ems, Stat. Region;Insgesamt;2480320;1229855;1250465
03401;      Delmenhorst, Kreisfreie Stadt;unter 3 Jahre;1745;923;822
03401;      Delmenhorst, Kreisfreie Stadt;3 bis unter 6 Jahre;1867;983;884
03401;      Delmenhorst, Kreisfreie Stadt;6 bis unter 10 Jahre;2705;1470;1235
03401;      Delmenhorst, Kreisfreie Stadt;10 bis unter 15 Jahre;3713;1882;1831
03401;      Delmenhorst, Kreisfreie Stadt;15 bis unter 18 Jahre;2435;1231;1204
03401;      Delmenhorst, Kreisfreie Stadt;18 bis unter 20 Jahre;1755;903;852
03401;      Delmenhorst, Kreisfreie Stadt;20 bis unter 25 Jahre;4483;2266;2217
03401;      Delmenhorst, Kreisfreie Stadt;25 bis unter 30 Jahre;4113;2102;2011
03401;      Delmenhorst, Kreisfreie Stadt;30 bis unter 35 Jahre;3865;1977;1888
03401;      Delmenhorst, Kreisfreie Stadt;35 bis unter 40 Jahre;4087;2027;2060
03401;      Delmenhorst, Kreisfreie Stadt;40 bis unter 45 Jahre;5573;2778;2795
03401;      Delmenhorst, Kreisfreie Stadt;45 bis unter 50 Jahre;6506;3440;3066
03401;      Delmenhorst, Kreisfreie Stadt;50 bis unter 55 Jahre;5672;2813;2859
03401;      Delmenhorst, Kreisfreie Stadt;55 bis unter 60 Jahre;4989;2430;2559
03401;      Delmenhorst, Kreisfreie Stadt;60 bis unter 65 Jahre;4880;2353;2527
03401;      Delmenhorst, Kreisfreie Stadt;65 bis unter 75 Jahre;9238;4445;4793
03401;      Delmenhorst, Kreisfreie Stadt;75 Jahre und mehr;6871;2690;4181
03401;      Delmenhorst, Kreisfreie Stadt;Insgesamt;74497;36713;37784
03402;      Emden, Kreisfreie Stadt;unter 3 Jahre;1260;660;600
03402;      Emden, Kreisfreie Stadt;3 bis unter 6 Jahre;1254;665;589
03402;      Emden, Kreisfreie Stadt;6 bis unter 10 Jahre;1775;887;888
03402;      Emden, Kreisfreie Stadt;10 bis unter 15 Jahre;2575;1303;1272
03402;      Emden, Kreisfreie Stadt;15 bis unter 18 Jahre;1601;825;776
03402;      Emden, Kreisfreie Stadt;18 bis unter 20 Jahre;1233;652;581
03402;      Emden, Kreisfreie Stadt;20 bis unter 25 Jahre;3716;1871;1845
03402;      Emden, Kreisfreie Stadt;25 bis unter 30 Jahre;3343;1760;1583
03402;      Emden, Kreisfreie Stadt;30 bis unter 35 Jahre;3010;1619;1391
03402;      Emden, Kreisfreie Stadt;35 bis unter 40 Jahre;2941;1565;1376
03402;      Emden, Kreisfreie Stadt;40 bis unter 45 Jahre;3988;2070;1918
03402;      Emden, Kreisfreie Stadt;45 bis unter 50 Jahre;4086;2145;1941
03402;      Emden, Kreisfreie Stadt;50 bis unter 55 Jahre;3653;1847;1806
03402;      Emden, Kreisfreie Stadt;55 bis unter 60 Jahre;3299;1648;1651
03402;      Emden, Kreisfreie Stadt;60 bis unter 65 Jahre;3184;1605;1579
03402;      Emden, Kreisfreie Stadt;65 bis unter 75 Jahre;5577;2640;2937
03402;      Emden, Kreisfreie Stadt;75 Jahre und mehr;5033;1926;3107
03402;      Emden, Kreisfreie Stadt;Insgesamt;51528;25688;25840
03403;      Oldenburg (Oldenburg), Kreisfreie Stadt;unter 3 Jahre;4080;2079;2001
03403;      Oldenburg (Oldenburg), Kreisfreie Stadt;3 bis unter 6 Jahre;3919;1988;1931
03403;      Oldenburg (Oldenburg), Kreisfreie Stadt;6 bis unter 10 Jahre;5347;2718;2629
03403;      Oldenburg (Oldenburg), Kreisfreie Stadt;10 bis unter 15 Jahre;7537;3839;3698
03403;      Oldenburg (Oldenburg), Kreisfreie Stadt;15 bis unter 18 Jahre;4488;2197;2291
03403;      Oldenburg (Oldenburg), Kreisfreie Stadt;18 bis unter 20 Jahre;3603;1740;1863
03403;      Oldenburg (Oldenburg), Kreisfreie Stadt;20 bis unter 25 Jahre;11599;5490;6109
03403;      Oldenburg (Oldenburg), Kreisfreie Stadt;25 bis unter 30 Jahre;12475;6229;6246
03403;      Oldenburg (Oldenburg), Kreisfreie Stadt;30 bis unter 35 Jahre;11236;5854;5382
03403;      Oldenburg (Oldenburg), Kreisfreie Stadt;35 bis unter 40 Jahre;10006;5007;4999
03403;      Oldenburg (Oldenburg), Kreisfreie Stadt;40 bis unter 45 Jahre;12931;6549;6382
03403;      Oldenburg (Oldenburg), Kreisfreie Stadt;45 bis unter 50 Jahre;14142;6905;7237
03403;      Oldenburg (Oldenburg), Kreisfreie Stadt;50 bis unter 55 Jahre;12169;5962;6207
03403;      Oldenburg (Oldenburg), Kreisfreie Stadt;55 bis unter 60 Jahre;10133;4934;5199
03403;      Oldenburg (Oldenburg), Kreisfreie Stadt;60 bis unter 65 Jahre;9047;4408;4639
03403;      Oldenburg (Oldenburg), Kreisfreie Stadt;65 bis unter 75 Jahre;16183;7554;8629
03403;      Oldenburg (Oldenburg), Kreisfreie Stadt;75 Jahre und mehr;13586;4979;8607
03403;      Oldenburg (Oldenburg), Kreisfreie Stadt;Insgesamt;162481;78432;84049
03404;      Osnabrück, Kreisfreie Stadt;unter 3 Jahre;4080;2098;1982
03404;      Osnabrück, Kreisfreie Stadt;3 bis unter 6 Jahre;3983;1996;1987
03404;      Osnabrück, Kreisfreie Stadt;6 bis unter 10 Jahre;5075;2595;2480
03404;      Osnabrück, Kreisfreie Stadt;10 bis unter 15 Jahre;6834;3514;3320
03404;      Osnabrück, Kreisfreie Stadt;15 bis unter 18 Jahre;4216;2187;2029
03404;      Osnabrück, Kreisfreie Stadt;18 bis unter 20 Jahre;3249;1543;1706
03404;      Osnabrück, Kreisfreie Stadt;20 bis unter 25 Jahre;12985;5920;7065
03404;      Osnabrück, Kreisfreie Stadt;25 bis unter 30 Jahre;13700;6719;6981
03404;      Osnabrück, Kreisfreie Stadt;30 bis unter 35 Jahre;11813;5996;5817
03404;      Osnabrück, Kreisfreie Stadt;35 bis unter 40 Jahre;10419;5255;5164
03404;      Osnabrück, Kreisfreie Stadt;40 bis unter 45 Jahre;12597;6480;6117
03404;      Osnabrück, Kreisfreie Stadt;45 bis unter 50 Jahre;13069;6512;6557
03404;      Osnabrück, Kreisfreie Stadt;50 bis unter 55 Jahre;12080;6139;5941
03404;      Osnabrück, Kreisfreie Stadt;55 bis unter 60 Jahre;10039;4815;5224
03404;      Osnabrück, Kreisfreie Stadt;60 bis unter 65 Jahre;8733;4295;4438
03404;      Osnabrück, Kreisfreie Stadt;65 bis unter 75 Jahre;16284;7395;8889
03404;      Osnabrück, Kreisfreie Stadt;75 Jahre und mehr;15865;5688;10177
03404;      Osnabrück, Kreisfreie Stadt;Insgesamt;165021;79147;85874
03405;      Wilhelmshaven, Kreisfreie Stadt;unter 3 Jahre;1649;815;834
03405;      Wilhelmshaven, Kreisfreie Stadt;3 bis unter 6 Jahre;1643;869;774
03405;      Wilhelmshaven, Kreisfreie Stadt;6 bis unter 10 Jahre;2246;1116;1130
03405;      Wilhelmshaven, Kreisfreie Stadt;10 bis unter 15 Jahre;3332;1688;1644
03405;      Wilhelmshaven, Kreisfreie Stadt;15 bis unter 18 Jahre;2228;1179;1049
03405;      Wilhelmshaven, Kreisfreie Stadt;18 bis unter 20 Jahre;1783;927;856
03405;      Wilhelmshaven, Kreisfreie Stadt;20 bis unter 25 Jahre;5910;3229;2681
03405;      Wilhelmshaven, Kreisfreie Stadt;25 bis unter 30 Jahre;5328;3113;2215
03405;      Wilhelmshaven, Kreisfreie Stadt;30 bis unter 35 Jahre;4119;2357;1762
03405;      Wilhelmshaven, Kreisfreie Stadt;35 bis unter 40 Jahre;3759;1986;1773
03405;      Wilhelmshaven, Kreisfreie Stadt;40 bis unter 45 Jahre;5531;2962;2569
03405;      Wilhelmshaven, Kreisfreie Stadt;45 bis unter 50 Jahre;7306;4137;3169
03405;      Wilhelmshaven, Kreisfreie Stadt;50 bis unter 55 Jahre;5872;3046;2826
03405;      Wilhelmshaven, Kreisfreie Stadt;55 bis unter 60 Jahre;5107;2530;2577
03405;      Wilhelmshaven, Kreisfreie Stadt;60 bis unter 65 Jahre;5341;2648;2693
03405;      Wilhelmshaven, Kreisfreie Stadt;65 bis unter 75 Jahre;10926;5225;5701
03405;      Wilhelmshaven, Kreisfreie Stadt;75 Jahre und mehr;8940;3316;5624
03405;      Wilhelmshaven, Kreisfreie Stadt;Insgesamt;81020;41143;39877
03451;      Ammerland, Landkreis;unter 3 Jahre;2797;1458;1339
03451;      Ammerland, Landkreis;3 bis unter 6 Jahre;3026;1555;1471
03451;      Ammerland, Landkreis;6 bis unter 10 Jahre;4743;2408;2335
03451;      Ammerland, Landkreis;10 bis unter 15 Jahre;6942;3557;3385
03451;      Ammerland, Landkreis;15 bis unter 18 Jahre;4112;2091;2021
03451;      Ammerland, Landkreis;18 bis unter 20 Jahre;2908;1525;1383
03451;      Ammerland, Landkreis;20 bis unter 25 Jahre;6219;3294;2925
03451;      Ammerland, Landkreis;25 bis unter 30 Jahre;5548;2855;2693
03451;      Ammerland, Landkreis;30 bis unter 35 Jahre;5820;2859;2961
03451;      Ammerland, Landkreis;35 bis unter 40 Jahre;6793;3340;3453
03451;      Ammerland, Landkreis;40 bis unter 45 Jahre;10016;5014;5002
03451;      Ammerland, Landkreis;45 bis unter 50 Jahre;10557;5291;5266
03451;      Ammerland, Landkreis;50 bis unter 55 Jahre;9139;4512;4627
03451;      Ammerland, Landkreis;55 bis unter 60 Jahre;7859;3806;4053
03451;      Ammerland, Landkreis;60 bis unter 65 Jahre;7574;3711;3863
03451;      Ammerland, Landkreis;65 bis unter 75 Jahre;13904;6736;7168
03451;      Ammerland, Landkreis;75 Jahre und mehr;10881;4416;6465
03451;      Ammerland, Landkreis;Insgesamt;118838;58428;60410
03452;      Aurich, Landkreis;unter 3 Jahre;4412;2282;2130
03452;      Aurich, Landkreis;3 bis unter 6 Jahre;4812;2557;2255
03452;      Aurich, Landkreis;6 bis unter 10 Jahre;7252;3746;3506
03452;      Aurich, Landkreis;10 bis unter 15 Jahre;11135;5608;5527
03452;      Aurich, Landkreis;15 bis unter 18 Jahre;7060;3641;3419
03452;      Aurich, Landkreis;18 bis unter 20 Jahre;4741;2522;2219
03452;      Aurich, Landkreis;20 bis unter 25 Jahre;10628;5468;5160
03452;      Aurich, Landkreis;25 bis unter 30 Jahre;9101;4634;4467
03452;      Aurich, Landkreis;30 bis unter 35 Jahre;9364;4613;4751
03452;      Aurich, Landkreis;35 bis unter 40 Jahre;10535;5189;5346
03452;      Aurich, Landkreis;40 bis unter 45 Jahre;15121;7472;7649
03452;      Aurich, Landkreis;45 bis unter 50 Jahre;15761;7752;8009
03452;      Aurich, Landkreis;50 bis unter 55 Jahre;14064;6842;7222
03452;      Aurich, Landkreis;55 bis unter 60 Jahre;12599;6131;6468
03452;      Aurich, Landkreis;60 bis unter 65 Jahre;12877;6440;6437
03452;      Aurich, Landkreis;65 bis unter 75 Jahre;21556;10333;11223
03452;      Aurich, Landkreis;75 Jahre und mehr;17312;6684;10628
03452;      Aurich, Landkreis;Insgesamt;188330;91914;96416
03453;      Cloppenburg, Landkreis;unter 3 Jahre;4747;2432;2315
03453;      Cloppenburg, Landkreis;3 bis unter 6 Jahre;4999;2584;2415
03453;      Cloppenburg, Landkreis;6 bis unter 10 Jahre;7530;3886;3644
03453;      Cloppenburg, Landkreis;10 bis unter 15 Jahre;10757;5601;5156
03453;      Cloppenburg, Landkreis;15 bis unter 18 Jahre;6613;3331;3282
03453;      Cloppenburg, Landkreis;18 bis unter 20 Jahre;4471;2352;2119
03453;      Cloppenburg, Landkreis;20 bis unter 25 Jahre;10576;5694;4882
03453;      Cloppenburg, Landkreis;25 bis unter 30 Jahre;9843;5312;4531
03453;      Cloppenburg, Landkreis;30 bis unter 35 Jahre;9467;4979;4488
03453;      Cloppenburg, Landkreis;35 bis unter 40 Jahre;9815;5163;4652
03453;      Cloppenburg, Landkreis;40 bis unter 45 Jahre;12672;6529;6143
03453;      Cloppenburg, Landkreis;45 bis unter 50 Jahre;13209;6934;6275
03453;      Cloppenburg, Landkreis;50 bis unter 55 Jahre;12039;6180;5859
03453;      Cloppenburg, Landkreis;55 bis unter 60 Jahre;9546;4865;4681
03453;      Cloppenburg, Landkreis;60 bis unter 65 Jahre;7791;4038;3753
03453;      Cloppenburg, Landkreis;65 bis unter 75 Jahre;13017;6163;6854
03453;      Cloppenburg, Landkreis;75 Jahre und mehr;11910;4568;7342
03453;      Cloppenburg, Landkreis;Insgesamt;159002;80611;78391
03454;      Emsland, Landkreis;unter 3 Jahre;8108;4155;3953
03454;      Emsland, Landkreis;3 bis unter 6 Jahre;8729;4481;4248
03454;      Emsland, Landkreis;6 bis unter 10 Jahre;12981;6613;6368
03454;      Emsland, Landkreis;10 bis unter 15 Jahre;18953;9794;9159
03454;      Emsland, Landkreis;15 bis unter 18 Jahre;11886;6089;5797
03454;      Emsland, Landkreis;18 bis unter 20 Jahre;8234;4259;3975
03454;      Emsland, Landkreis;20 bis unter 25 Jahre;19723;10611;9112
03454;      Emsland, Landkreis;25 bis unter 30 Jahre;18559;9898;8661
03454;      Emsland, Landkreis;30 bis unter 35 Jahre;18106;9554;8552
03454;      Emsland, Landkreis;35 bis unter 40 Jahre;19076;10121;8955
03454;      Emsland, Landkreis;40 bis unter 45 Jahre;25383;13180;12203
03454;      Emsland, Landkreis;45 bis unter 50 Jahre;26715;13976;12739
03454;      Emsland, Landkreis;50 bis unter 55 Jahre;23991;12214;11777
03454;      Emsland, Landkreis;55 bis unter 60 Jahre;20475;10411;10064
03454;      Emsland, Landkreis;60 bis unter 65 Jahre;17300;8834;8466
03454;      Emsland, Landkreis;65 bis unter 75 Jahre;30129;14652;15477
03454;      Emsland, Landkreis;75 Jahre und mehr;25191;9721;15470
03454;      Emsland, Landkreis;Insgesamt;313539;158563;154976
03455;      Friesland, Landkreis;unter 3 Jahre;2121;1120;1001
03455;      Friesland, Landkreis;3 bis unter 6 Jahre;2266;1162;1104
03455;      Friesland, Landkreis;6 bis unter 10 Jahre;3486;1772;1714
03455;      Friesland, Landkreis;10 bis unter 15 Jahre;5626;2828;2798
03455;      Friesland, Landkreis;15 bis unter 18 Jahre;3615;1899;1716
03455;      Friesland, Landkreis;18 bis unter 20 Jahre;2338;1249;1089
03455;      Friesland, Landkreis;20 bis unter 25 Jahre;5026;2649;2377
03455;      Friesland, Landkreis;25 bis unter 30 Jahre;4219;2159;2060
03455;      Friesland, Landkreis;30 bis unter 35 Jahre;4489;2209;2280
03455;      Friesland, Landkreis;35 bis unter 40 Jahre;5124;2492;2632
03455;      Friesland, Landkreis;40 bis unter 45 Jahre;7963;3897;4066
03455;      Friesland, Landkreis;45 bis unter 50 Jahre;8787;4410;4377
03455;      Friesland, Landkreis;50 bis unter 55 Jahre;7451;3634;3817
03455;      Friesland, Landkreis;55 bis unter 60 Jahre;6555;3282;3273
03455;      Friesland, Landkreis;60 bis unter 65 Jahre;6779;3252;3527
03455;      Friesland, Landkreis;65 bis unter 75 Jahre;13251;6493;6758
03455;      Friesland, Landkreis;75 Jahre und mehr;10100;3985;6115
03455;      Friesland, Landkreis;Insgesamt;99196;48492;50704
03456;      Grafschaft Bentheim, Landkreis;unter 3 Jahre;3548;1830;1718
03456;      Grafschaft Bentheim, Landkreis;3 bis unter 6 Jahre;3750;1915;1835
03456;      Grafschaft Bentheim, Landkreis;6 bis unter 10 Jahre;5487;2826;2661
03456;      Grafschaft Bentheim, Landkreis;10 bis unter 15 Jahre;8234;4243;3991
03456;      Grafschaft Bentheim, Landkreis;15 bis unter 18 Jahre;5124;2596;2528
03456;      Grafschaft Bentheim, Landkreis;18 bis unter 20 Jahre;3564;1779;1785
03456;      Grafschaft Bentheim, Landkreis;20 bis unter 25 Jahre;8084;4225;3859
03456;      Grafschaft Bentheim, Landkreis;25 bis unter 30 Jahre;7206;3744;3462
03456;      Grafschaft Bentheim, Landkreis;30 bis unter 35 Jahre;7275;3662;3613
03456;      Grafschaft Bentheim, Landkreis;35 bis unter 40 Jahre;7989;4007;3982
03456;      Grafschaft Bentheim, Landkreis;40 bis unter 45 Jahre;10748;5375;5373
03456;      Grafschaft Bentheim, Landkreis;45 bis unter 50 Jahre;11468;5856;5612
03456;      Grafschaft Bentheim, Landkreis;50 bis unter 55 Jahre;9800;4957;4843
03456;      Grafschaft Bentheim, Landkreis;55 bis unter 60 Jahre;8859;4450;4409
03456;      Grafschaft Bentheim, Landkreis;60 bis unter 65 Jahre;7934;3948;3986
03456;      Grafschaft Bentheim, Landkreis;65 bis unter 75 Jahre;13377;6521;6856
03456;      Grafschaft Bentheim, Landkreis;75 Jahre und mehr;12356;4935;7421
03456;      Grafschaft Bentheim, Landkreis;Insgesamt;134803;66869;67934
03457;      Leer, Landkreis;unter 3 Jahre;4054;2037;2017
03457;      Leer, Landkreis;3 bis unter 6 Jahre;4346;2183;2163
03457;      Leer, Landkreis;6 bis unter 10 Jahre;6568;3344;3224
03457;      Leer, Landkreis;10 bis unter 15 Jahre;9806;4950;4856
03457;      Leer, Landkreis;15 bis unter 18 Jahre;6092;3048;3044
03457;      Leer, Landkreis;18 bis unter 20 Jahre;4179;2159;2020
03457;      Leer, Landkreis;20 bis unter 25 Jahre;9674;5071;4603
03457;      Leer, Landkreis;25 bis unter 30 Jahre;8764;4622;4142
03457;      Leer, Landkreis;30 bis unter 35 Jahre;8739;4568;4171
03457;      Leer, Landkreis;35 bis unter 40 Jahre;9546;4762;4784
03457;      Leer, Landkreis;40 bis unter 45 Jahre;13374;6835;6539
03457;      Leer, Landkreis;45 bis unter 50 Jahre;14090;7229;6861
03457;      Leer, Landkreis;50 bis unter 55 Jahre;12452;6200;6252
03457;      Leer, Landkreis;55 bis unter 60 Jahre;10665;5378;5287
03457;      Leer, Landkreis;60 bis unter 65 Jahre;10143;5023;5120
03457;      Leer, Landkreis;65 bis unter 75 Jahre;18010;8656;9354
03457;      Leer, Landkreis;75 Jahre und mehr;14494;5578;8916
03457;      Leer, Landkreis;Insgesamt;164996;81643;83353
03458;      Oldenburg, Landkreis;unter 3 Jahre;2993;1570;1423
03458;      Oldenburg, Landkreis;3 bis unter 6 Jahre;3280;1666;1614
03458;      Oldenburg, Landkreis;6 bis unter 10 Jahre;5075;2673;2402
03458;      Oldenburg, Landkreis;10 bis unter 15 Jahre;7559;3836;3723
03458;      Oldenburg, Landkreis;15 bis unter 18 Jahre;4610;2325;2285
03458;      Oldenburg, Landkreis;18 bis unter 20 Jahre;3044;1570;1474
03458;      Oldenburg, Landkreis;20 bis unter 25 Jahre;6773;3620;3153
03458;      Oldenburg, Landkreis;25 bis unter 30 Jahre;5803;2977;2826
03458;      Oldenburg, Landkreis;30 bis unter 35 Jahre;6379;3158;3221
03458;      Oldenburg, Landkreis;35 bis unter 40 Jahre;7367;3559;3808
03458;      Oldenburg, Landkreis;40 bis unter 45 Jahre;11187;5521;5666
03458;      Oldenburg, Landkreis;45 bis unter 50 Jahre;12306;6278;6028
03458;      Oldenburg, Landkreis;50 bis unter 55 Jahre;10384;5179;5205
03458;      Oldenburg, Landkreis;55 bis unter 60 Jahre;8530;4294;4236
03458;      Oldenburg, Landkreis;60 bis unter 65 Jahre;7651;3898;3753
03458;      Oldenburg, Landkreis;65 bis unter 75 Jahre;13790;6743;7047
03458;      Oldenburg, Landkreis;75 Jahre und mehr;10862;4279;6583
03458;      Oldenburg, Landkreis;Insgesamt;127593;63146;64447
03459;      Osnabrück, Landkreis;unter 3 Jahre;8984;4597;4387
03459;      Osnabrück, Landkreis;3 bis unter 6 Jahre;9713;5016;4697
03459;      Osnabrück, Landkreis;6 bis unter 10 Jahre;14606;7361;7245
03459;      Osnabrück, Landkreis;10 bis unter 15 Jahre;21334;11152;10182
03459;      Osnabrück, Landkreis;15 bis unter 18 Jahre;13199;6739;6460
03459;      Osnabrück, Landkreis;18 bis unter 20 Jahre;8933;4657;4276
03459;      Osnabrück, Landkreis;20 bis unter 25 Jahre;20983;11285;9698
03459;      Osnabrück, Landkreis;25 bis unter 30 Jahre;18222;9645;8577
03459;      Osnabrück, Landkreis;30 bis unter 35 Jahre;18940;9666;9274
03459;      Osnabrück, Landkreis;35 bis unter 40 Jahre;20991;10480;10511
03459;      Osnabrück, Landkreis;40 bis unter 45 Jahre;28441;14353;14088
03459;      Osnabrück, Landkreis;45 bis unter 50 Jahre;31676;16090;15586
03459;      Osnabrück, Landkreis;50 bis unter 55 Jahre;28627;14752;13875
03459;      Osnabrück, Landkreis;55 bis unter 60 Jahre;23547;12155;11392
03459;      Osnabrück, Landkreis;60 bis unter 65 Jahre;19785;10062;9723
03459;      Osnabrück, Landkreis;65 bis unter 75 Jahre;35312;17117;18195
03459;      Osnabrück, Landkreis;75 Jahre und mehr;32696;12808;19888
03459;      Osnabrück, Landkreis;Insgesamt;355989;177935;178054
03460;      Vechta, Landkreis;unter 3 Jahre;3933;2042;1891
03460;      Vechta, Landkreis;3 bis unter 6 Jahre;4110;2107;2003
03460;      Vechta, Landkreis;6 bis unter 10 Jahre;6090;3128;2962
03460;      Vechta, Landkreis;10 bis unter 15 Jahre;8770;4568;4202
03460;      Vechta, Landkreis;15 bis unter 18 Jahre;5378;2750;2628
03460;      Vechta, Landkreis;18 bis unter 20 Jahre;3649;1811;1838
03460;      Vechta, Landkreis;20 bis unter 25 Jahre;9741;5051;4690
03460;      Vechta, Landkreis;25 bis unter 30 Jahre;8868;4649;4219
03460;      Vechta, Landkreis;30 bis unter 35 Jahre;8331;4151;4180
03460;      Vechta, Landkreis;35 bis unter 40 Jahre;8735;4507;4228
03460;      Vechta, Landkreis;40 bis unter 45 Jahre;11115;5733;5382
03460;      Vechta, Landkreis;45 bis unter 50 Jahre;12110;6134;5976
03460;      Vechta, Landkreis;50 bis unter 55 Jahre;10421;5383;5038
03460;      Vechta, Landkreis;55 bis unter 60 Jahre;8223;4237;3986
03460;      Vechta, Landkreis;60 bis unter 65 Jahre;6517;3346;3171
03460;      Vechta, Landkreis;65 bis unter 75 Jahre;10672;5167;5505
03460;      Vechta, Landkreis;75 Jahre und mehr;9832;3704;6128
03460;      Vechta, Landkreis;Insgesamt;136495;68468;68027
03461;      Wesermarsch, Landkreis;unter 3 Jahre;1900;1019;881
03461;      Wesermarsch, Landkreis;3 bis unter 6 Jahre;2155;1101;1054
03461;      Wesermarsch, Landkreis;6 bis unter 10 Jahre;3301;1651;1650
03461;      Wesermarsch, Landkreis;10 bis unter 15 Jahre;5247;2759;2488
03461;      Wesermarsch, Landkreis;15 bis unter 18 Jahre;3216;1691;1525
03461;      Wesermarsch, Landkreis;18 bis unter 20 Jahre;2297;1197;1100
03461;      Wesermarsch, Landkreis;20 bis unter 25 Jahre;4976;2664;2312
03461;      Wesermarsch, Landkreis;25 bis unter 30 Jahre;4066;2156;1910
03461;      Wesermarsch, Landkreis;30 bis unter 35 Jahre;4071;2038;2033
03461;      Wesermarsch, Landkreis;35 bis unter 40 Jahre;4791;2405;2386
03461;      Wesermarsch, Landkreis;40 bis unter 45 Jahre;7069;3621;3448
03461;      Wesermarsch, Landkreis;45 bis unter 50 Jahre;7965;4025;3940
03461;      Wesermarsch, Landkreis;50 bis unter 55 Jahre;7122;3643;3479
03461;      Wesermarsch, Landkreis;55 bis unter 60 Jahre;6256;3183;3073
03461;      Wesermarsch, Landkreis;60 bis unter 65 Jahre;5860;2970;2890
03461;      Wesermarsch, Landkreis;65 bis unter 75 Jahre;10700;5244;5456
03461;      Wesermarsch, Landkreis;75 Jahre und mehr;8990;3516;5474
03461;      Wesermarsch, Landkreis;Insgesamt;89982;44883;45099
03462;      Wittmund, Landkreis;unter 3 Jahre;1297;682;615
03462;      Wittmund, Landkreis;3 bis unter 6 Jahre;1383;710;673
03462;      Wittmund, Landkreis;6 bis unter 10 Jahre;2103;1045;1058
03462;      Wittmund, Landkreis;10 bis unter 15 Jahre;3424;1722;1702
03462;      Wittmund, Landkreis;15 bis unter 18 Jahre;2046;1021;1025
03462;      Wittmund, Landkreis;18 bis unter 20 Jahre;1379;682;697
03462;      Wittmund, Landkreis;20 bis unter 25 Jahre;3036;1624;1412
03462;      Wittmund, Landkreis;25 bis unter 30 Jahre;2649;1310;1339
03462;      Wittmund, Landkreis;30 bis unter 35 Jahre;2775;1387;1388
03462;      Wittmund, Landkreis;35 bis unter 40 Jahre;3106;1569;1537
03462;      Wittmund, Landkreis;40 bis unter 45 Jahre;4591;2263;2328
03462;      Wittmund, Landkreis;45 bis unter 50 Jahre;4602;2327;2275
03462;      Wittmund, Landkreis;50 bis unter 55 Jahre;4446;2132;2314
03462;      Wittmund, Landkreis;55 bis unter 60 Jahre;3760;1771;1989
03462;      Wittmund, Landkreis;60 bis unter 65 Jahre;4036;2044;1992
03462;      Wittmund, Landkreis;65 bis unter 75 Jahre;6774;3363;3411
03462;      Wittmund, Landkreis;75 Jahre und mehr;5603;2128;3475
03462;      Wittmund, Landkreis;Insgesamt;57010;27780;29230
04;  Bremen;unter 3 Jahre;16155;8319;7836
04;  Bremen;3 bis unter 6 Jahre;16123;8247;7876
04;  Bremen;6 bis unter 10 Jahre;20758;10749;10009
04;  Bremen;10 bis unter 15 Jahre;28778;14825;13953
04;  Bremen;15 bis unter 18 Jahre;18015;9287;8728
04;  Bremen;18 bis unter 20 Jahre;13575;6906;6669
04;  Bremen;20 bis unter 25 Jahre;45010;22173;22837
04;  Bremen;25 bis unter 30 Jahre;45816;23214;22602
04;  Bremen;30 bis unter 35 Jahre;42366;21679;20687
04;  Bremen;35 bis unter 40 Jahre;39858;20434;19424
04;  Bremen;40 bis unter 45 Jahre;49522;25754;23768
04;  Bremen;45 bis unter 50 Jahre;53275;27608;25667
04;  Bremen;50 bis unter 55 Jahre;47548;23522;24026
04;  Bremen;55 bis unter 60 Jahre;42346;20513;21833
04;  Bremen;60 bis unter 65 Jahre;39886;19287;20599
04;  Bremen;65 bis unter 75 Jahre;76178;35842;40336
04;  Bremen;75 Jahre und mehr;66092;24418;41674
04;  Bremen;Insgesamt;661301;322777;338524
04011;      Bremen, Kreisfreie Stadt;unter 3 Jahre;13365;6892;6473
04011;      Bremen, Kreisfreie Stadt;3 bis unter 6 Jahre;13244;6741;6503
04011;      Bremen, Kreisfreie Stadt;6 bis unter 10 Jahre;17084;8859;8225
04011;      Bremen, Kreisfreie Stadt;10 bis unter 15 Jahre;23521;12127;11394
04011;      Bremen, Kreisfreie Stadt;15 bis unter 18 Jahre;14656;7561;7095
04011;      Bremen, Kreisfreie Stadt;18 bis unter 20 Jahre;11113;5631;5482
04011;      Bremen, Kreisfreie Stadt;20 bis unter 25 Jahre;37505;18372;19133
04011;      Bremen, Kreisfreie Stadt;25 bis unter 30 Jahre;38771;19405;19366
04011;      Bremen, Kreisfreie Stadt;30 bis unter 35 Jahre;36176;18428;17748
04011;      Bremen, Kreisfreie Stadt;35 bis unter 40 Jahre;33700;17155;16545
04011;      Bremen, Kreisfreie Stadt;40 bis unter 45 Jahre;41441;21402;20039
04011;      Bremen, Kreisfreie Stadt;45 bis unter 50 Jahre;44299;22977;21322
04011;      Bremen, Kreisfreie Stadt;50 bis unter 55 Jahre;38983;19189;19794
04011;      Bremen, Kreisfreie Stadt;55 bis unter 60 Jahre;34379;16639;17740
04011;      Bremen, Kreisfreie Stadt;60 bis unter 65 Jahre;32740;15745;16995
04011;      Bremen, Kreisfreie Stadt;65 bis unter 75 Jahre;62783;29371;33412
04011;      Bremen, Kreisfreie Stadt;75 Jahre und mehr;54559;20060;34499
04011;      Bremen, Kreisfreie Stadt;Insgesamt;548319;266554;281765
04012;      Bremerhaven, Kreisfreie Stadt;unter 3 Jahre;2790;1427;1363
04012;      Bremerhaven, Kreisfreie Stadt;3 bis unter 6 Jahre;2879;1506;1373
04012;      Bremerhaven, Kreisfreie Stadt;6 bis unter 10 Jahre;3674;1890;1784
04012;      Bremerhaven, Kreisfreie Stadt;10 bis unter 15 Jahre;5257;2698;2559
04012;      Bremerhaven, Kreisfreie Stadt;15 bis unter 18 Jahre;3359;1726;1633
04012;      Bremerhaven, Kreisfreie Stadt;18 bis unter 20 Jahre;2462;1275;1187
04012;      Bremerhaven, Kreisfreie Stadt;20 bis unter 25 Jahre;7505;3801;3704
04012;      Bremerhaven, Kreisfreie Stadt;25 bis unter 30 Jahre;7045;3809;3236
04012;      Bremerhaven, Kreisfreie Stadt;30 bis unter 35 Jahre;6190;3251;2939
04012;      Bremerhaven, Kreisfreie Stadt;35 bis unter 40 Jahre;6158;3279;2879
04012;      Bremerhaven, Kreisfreie Stadt;40 bis unter 45 Jahre;8081;4352;3729
04012;      Bremerhaven, Kreisfreie Stadt;45 bis unter 50 Jahre;8976;4631;4345
04012;      Bremerhaven, Kreisfreie Stadt;50 bis unter 55 Jahre;8565;4333;4232
04012;      Bremerhaven, Kreisfreie Stadt;55 bis unter 60 Jahre;7967;3874;4093
04012;      Bremerhaven, Kreisfreie Stadt;60 bis unter 65 Jahre;7146;3542;3604
04012;      Bremerhaven, Kreisfreie Stadt;65 bis unter 75 Jahre;13395;6471;6924
04012;      Bremerhaven, Kreisfreie Stadt;75 Jahre und mehr;11533;4358;7175
04012;      Bremerhaven, Kreisfreie Stadt;Insgesamt;112982;56223;56759
05;  Nordrhein-Westfalen;unter 3 Jahre;437376;224031;213345
05;  Nordrhein-Westfalen;3 bis unter 6 Jahre;455250;233524;221726
05;  Nordrhein-Westfalen;6 bis unter 10 Jahre;637609;327329;310280
05;  Nordrhein-Westfalen;10 bis unter 15 Jahre;903625;463009;440616
05;  Nordrhein-Westfalen;15 bis unter 18 Jahre;571697;293131;278566
05;  Nordrhein-Westfalen;18 bis unter 20 Jahre;411414;211021;200393
05;  Nordrhein-Westfalen;20 bis unter 25 Jahre;1095961;559245;536716
05;  Nordrhein-Westfalen;25 bis unter 30 Jahre;1057288;534436;522852
05;  Nordrhein-Westfalen;30 bis unter 35 Jahre;1037857;519504;518353
05;  Nordrhein-Westfalen;35 bis unter 40 Jahre;1038562;518369;520193
05;  Nordrhein-Westfalen;40 bis unter 45 Jahre;1398013;705552;692461
05;  Nordrhein-Westfalen;45 bis unter 50 Jahre;1549637;786611;763026
05;  Nordrhein-Westfalen;50 bis unter 55 Jahre;1393169;699066;694103
05;  Nordrhein-Westfalen;55 bis unter 60 Jahre;1191775;587264;604511
05;  Nordrhein-Westfalen;60 bis unter 65 Jahre;1038800;506840;531960
05;  Nordrhein-Westfalen;65 bis unter 75 Jahre;1906741;893470;1013271
05;  Nordrhein-Westfalen;75 Jahre und mehr;1717182;655617;1061565
05;  Nordrhein-Westfalen;Insgesamt;17841956;8718019;9123937
051;    Düsseldorf, Regierungsbezirk;unter 3 Jahre;124720;63676;61044
051;    Düsseldorf, Regierungsbezirk;3 bis unter 6 Jahre;129220;66018;63202
051;    Düsseldorf, Regierungsbezirk;6 bis unter 10 Jahre;177899;91180;86719
051;    Düsseldorf, Regierungsbezirk;10 bis unter 15 Jahre;246678;126364;120314
051;    Düsseldorf, Regierungsbezirk;15 bis unter 18 Jahre;157380;80617;76763
051;    Düsseldorf, Regierungsbezirk;18 bis unter 20 Jahre;113389;58229;55160
051;    Düsseldorf, Regierungsbezirk;20 bis unter 25 Jahre;300442;151013;149429
051;    Düsseldorf, Regierungsbezirk;25 bis unter 30 Jahre;298069;148075;149994
051;    Düsseldorf, Regierungsbezirk;30 bis unter 35 Jahre;300892;149667;151225
051;    Düsseldorf, Regierungsbezirk;35 bis unter 40 Jahre;298773;148860;149913
051;    Düsseldorf, Regierungsbezirk;40 bis unter 45 Jahre;404825;204063;200762
051;    Düsseldorf, Regierungsbezirk;45 bis unter 50 Jahre;448289;226382;221907
051;    Düsseldorf, Regierungsbezirk;50 bis unter 55 Jahre;404110;201388;202722
051;    Düsseldorf, Regierungsbezirk;55 bis unter 60 Jahre;349551;171300;178251
051;    Düsseldorf, Regierungsbezirk;60 bis unter 65 Jahre;309460;149224;160236
051;    Düsseldorf, Regierungsbezirk;65 bis unter 75 Jahre;579988;269509;310479
051;    Düsseldorf, Regierungsbezirk;75 Jahre und mehr;513782;196058;317724
051;    Düsseldorf, Regierungsbezirk;Insgesamt;5157467;2501623;2655844
05111;      Düsseldorf, Kreisfreie Stadt;unter 3 Jahre;16875;8574;8301
05111;      Düsseldorf, Kreisfreie Stadt;3 bis unter 6 Jahre;15722;8096;7626
05111;      Düsseldorf, Kreisfreie Stadt;6 bis unter 10 Jahre;19183;9763;9420
05111;      Düsseldorf, Kreisfreie Stadt;10 bis unter 15 Jahre;23437;12057;11380
05111;      Düsseldorf, Kreisfreie Stadt;15 bis unter 18 Jahre;13940;7124;6816
05111;      Düsseldorf, Kreisfreie Stadt;18 bis unter 20 Jahre;10496;5208;5288
05111;      Düsseldorf, Kreisfreie Stadt;20 bis unter 25 Jahre;33545;15624;17921
05111;      Düsseldorf, Kreisfreie Stadt;25 bis unter 30 Jahre;44191;20521;23670
05111;      Düsseldorf, Kreisfreie Stadt;30 bis unter 35 Jahre;48011;23510;24501
05111;      Düsseldorf, Kreisfreie Stadt;35 bis unter 40 Jahre;43229;21816;21413
05111;      Düsseldorf, Kreisfreie Stadt;40 bis unter 45 Jahre;49351;25140;24211
05111;      Düsseldorf, Kreisfreie Stadt;45 bis unter 50 Jahre;49912;24924;24988
05111;      Düsseldorf, Kreisfreie Stadt;50 bis unter 55 Jahre;41520;20612;20908
05111;      Düsseldorf, Kreisfreie Stadt;55 bis unter 60 Jahre;35085;16787;18298
05111;      Düsseldorf, Kreisfreie Stadt;60 bis unter 65 Jahre;32227;14992;17235
05111;      Düsseldorf, Kreisfreie Stadt;65 bis unter 75 Jahre;62923;28431;34492
05111;      Düsseldorf, Kreisfreie Stadt;75 Jahre und mehr;52746;19229;33517
05111;      Düsseldorf, Kreisfreie Stadt;Insgesamt;592393;282408;309985
05112;      Duisburg, Kreisfreie Stadt;unter 3 Jahre;12305;6319;5986
05112;      Duisburg, Kreisfreie Stadt;3 bis unter 6 Jahre;12349;6327;6022
05112;      Duisburg, Kreisfreie Stadt;6 bis unter 10 Jahre;17074;8792;8282
05112;      Duisburg, Kreisfreie Stadt;10 bis unter 15 Jahre;23514;12150;11364
05112;      Duisburg, Kreisfreie Stadt;15 bis unter 18 Jahre;15019;7655;7364
05112;      Duisburg, Kreisfreie Stadt;18 bis unter 20 Jahre;11190;5781;5409
05112;      Duisburg, Kreisfreie Stadt;20 bis unter 25 Jahre;30540;15438;15102
05112;      Duisburg, Kreisfreie Stadt;25 bis unter 30 Jahre;28628;14570;14058
05112;      Duisburg, Kreisfreie Stadt;30 bis unter 35 Jahre;29677;15180;14497
05112;      Duisburg, Kreisfreie Stadt;35 bis unter 40 Jahre;29133;14989;14144
05112;      Duisburg, Kreisfreie Stadt;40 bis unter 45 Jahre;36536;18860;17676
05112;      Duisburg, Kreisfreie Stadt;45 bis unter 50 Jahre;40466;21120;19346
05112;      Duisburg, Kreisfreie Stadt;50 bis unter 55 Jahre;36945;18692;18253
05112;      Duisburg, Kreisfreie Stadt;55 bis unter 60 Jahre;33173;16381;16792
05112;      Duisburg, Kreisfreie Stadt;60 bis unter 65 Jahre;27878;13516;14362
05112;      Duisburg, Kreisfreie Stadt;65 bis unter 75 Jahre;52408;24473;27935
05112;      Duisburg, Kreisfreie Stadt;75 Jahre und mehr;51170;19487;31683
05112;      Duisburg, Kreisfreie Stadt;Insgesamt;488005;239730;248275
05113;      Essen, Kreisfreie Stadt;unter 3 Jahre;13693;6931;6762
05113;      Essen, Kreisfreie Stadt;3 bis unter 6 Jahre;14110;7193;6917
05113;      Essen, Kreisfreie Stadt;6 bis unter 10 Jahre;18455;9432;9023
05113;      Essen, Kreisfreie Stadt;10 bis unter 15 Jahre;24864;12829;12035
05113;      Essen, Kreisfreie Stadt;15 bis unter 18 Jahre;16194;8237;7957
05113;      Essen, Kreisfreie Stadt;18 bis unter 20 Jahre;12014;6062;5952
05113;      Essen, Kreisfreie Stadt;20 bis unter 25 Jahre;36037;17647;18390
05113;      Essen, Kreisfreie Stadt;25 bis unter 30 Jahre;37194;18306;18888
05113;      Essen, Kreisfreie Stadt;30 bis unter 35 Jahre;35334;17710;17624
05113;      Essen, Kreisfreie Stadt;35 bis unter 40 Jahre;33317;16859;16458
05113;      Essen, Kreisfreie Stadt;40 bis unter 45 Jahre;41806;21318;20488
05113;      Essen, Kreisfreie Stadt;45 bis unter 50 Jahre;45900;23201;22699
05113;      Essen, Kreisfreie Stadt;50 bis unter 55 Jahre;42960;21310;21650
05113;      Essen, Kreisfreie Stadt;55 bis unter 60 Jahre;39503;19366;20137
05113;      Essen, Kreisfreie Stadt;60 bis unter 65 Jahre;35008;16947;18061
05113;      Essen, Kreisfreie Stadt;65 bis unter 75 Jahre;65153;29965;35188
05113;      Essen, Kreisfreie Stadt;75 Jahre und mehr;61926;22716;39210
05113;      Essen, Kreisfreie Stadt;Insgesamt;573468;276029;297439
05114;      Krefeld, Kreisfreie Stadt;unter 3 Jahre;5428;2775;2653
05114;      Krefeld, Kreisfreie Stadt;3 bis unter 6 Jahre;5801;2976;2825
05114;      Krefeld, Kreisfreie Stadt;6 bis unter 10 Jahre;7979;4127;3852
05114;      Krefeld, Kreisfreie Stadt;10 bis unter 15 Jahre;11185;5670;5515
05114;      Krefeld, Kreisfreie Stadt;15 bis unter 18 Jahre;6988;3599;3389
05114;      Krefeld, Kreisfreie Stadt;18 bis unter 20 Jahre;5134;2625;2509
05114;      Krefeld, Kreisfreie Stadt;20 bis unter 25 Jahre;13615;6907;6708
05114;      Krefeld, Kreisfreie Stadt;25 bis unter 30 Jahre;13416;6739;6677
05114;      Krefeld, Kreisfreie Stadt;30 bis unter 35 Jahre;12429;6190;6239
05114;      Krefeld, Kreisfreie Stadt;35 bis unter 40 Jahre;12879;6358;6521
05114;      Krefeld, Kreisfreie Stadt;40 bis unter 45 Jahre;19117;9595;9522
05114;      Krefeld, Kreisfreie Stadt;45 bis unter 50 Jahre;21314;10925;10389
05114;      Krefeld, Kreisfreie Stadt;50 bis unter 55 Jahre;18952;9508;9444
05114;      Krefeld, Kreisfreie Stadt;55 bis unter 60 Jahre;15665;7748;7917
05114;      Krefeld, Kreisfreie Stadt;60 bis unter 65 Jahre;14045;6720;7325
05114;      Krefeld, Kreisfreie Stadt;65 bis unter 75 Jahre;26916;12630;14286
05114;      Krefeld, Kreisfreie Stadt;75 Jahre und mehr;23533;8992;14541
05114;      Krefeld, Kreisfreie Stadt;Insgesamt;234396;114084;120312
05116;      Mönchengladbach, Kreisfreie Stadt;unter 3 Jahre;6211;3136;3075
05116;      Mönchengladbach, Kreisfreie Stadt;3 bis unter 6 Jahre;6551;3390;3161
05116;      Mönchengladbach, Kreisfreie Stadt;6 bis unter 10 Jahre;9072;4637;4435
05116;      Mönchengladbach, Kreisfreie Stadt;10 bis unter 15 Jahre;12856;6551;6305
05116;      Mönchengladbach, Kreisfreie Stadt;15 bis unter 18 Jahre;8295;4264;4031
05116;      Mönchengladbach, Kreisfreie Stadt;18 bis unter 20 Jahre;5955;3077;2878
05116;      Mönchengladbach, Kreisfreie Stadt;20 bis unter 25 Jahre;16491;8141;8350
05116;      Mönchengladbach, Kreisfreie Stadt;25 bis unter 30 Jahre;15656;7922;7734
05116;      Mönchengladbach, Kreisfreie Stadt;30 bis unter 35 Jahre;14596;7292;7304
05116;      Mönchengladbach, Kreisfreie Stadt;35 bis unter 40 Jahre;14109;7099;7010
05116;      Mönchengladbach, Kreisfreie Stadt;40 bis unter 45 Jahre;19567;10055;9512
05116;      Mönchengladbach, Kreisfreie Stadt;45 bis unter 50 Jahre;21938;10943;10995
05116;      Mönchengladbach, Kreisfreie Stadt;50 bis unter 55 Jahre;20153;9973;10180
05116;      Mönchengladbach, Kreisfreie Stadt;55 bis unter 60 Jahre;17712;8607;9105
05116;      Mönchengladbach, Kreisfreie Stadt;60 bis unter 65 Jahre;15530;7574;7956
05116;      Mönchengladbach, Kreisfreie Stadt;65 bis unter 75 Jahre;28127;13116;15011
05116;      Mönchengladbach, Kreisfreie Stadt;75 Jahre und mehr;24389;9180;15209
05116;      Mönchengladbach, Kreisfreie Stadt;Insgesamt;257208;124957;132251
05117;      Mülheim an der Ruhr, Kreisfreie Stadt;unter 3 Jahre;3932;2043;1889
05117;      Mülheim an der Ruhr, Kreisfreie Stadt;3 bis unter 6 Jahre;3937;1953;1984
05117;      Mülheim an der Ruhr, Kreisfreie Stadt;6 bis unter 10 Jahre;5485;2807;2678
05117;      Mülheim an der Ruhr, Kreisfreie Stadt;10 bis unter 15 Jahre;7393;3807;3586
05117;      Mülheim an der Ruhr, Kreisfreie Stadt;15 bis unter 18 Jahre;4712;2372;2340
05117;      Mülheim an der Ruhr, Kreisfreie Stadt;18 bis unter 20 Jahre;3361;1702;1659
05117;      Mülheim an der Ruhr, Kreisfreie Stadt;20 bis unter 25 Jahre;9060;4641;4419
05117;      Mülheim an der Ruhr, Kreisfreie Stadt;25 bis unter 30 Jahre;8689;4419;4270
05117;      Mülheim an der Ruhr, Kreisfreie Stadt;30 bis unter 35 Jahre;8698;4285;4413
05117;      Mülheim an der Ruhr, Kreisfreie Stadt;35 bis unter 40 Jahre;8925;4324;4601
05117;      Mülheim an der Ruhr, Kreisfreie Stadt;40 bis unter 45 Jahre;12909;6510;6399
05117;      Mülheim an der Ruhr, Kreisfreie Stadt;45 bis unter 50 Jahre;14331;7096;7235
05117;      Mülheim an der Ruhr, Kreisfreie Stadt;50 bis unter 55 Jahre;13199;6529;6670
05117;      Mülheim an der Ruhr, Kreisfreie Stadt;55 bis unter 60 Jahre;11860;5740;6120
05117;      Mülheim an der Ruhr, Kreisfreie Stadt;60 bis unter 65 Jahre;10459;5007;5452
05117;      Mülheim an der Ruhr, Kreisfreie Stadt;65 bis unter 75 Jahre;20788;9446;11342
05117;      Mülheim an der Ruhr, Kreisfreie Stadt;75 Jahre und mehr;19418;7545;11873
05117;      Mülheim an der Ruhr, Kreisfreie Stadt;Insgesamt;167156;80226;86930
05119;      Oberhausen, Kreisfreie Stadt;unter 3 Jahre;4911;2500;2411
05119;      Oberhausen, Kreisfreie Stadt;3 bis unter 6 Jahre;5061;2621;2440
05119;      Oberhausen, Kreisfreie Stadt;6 bis unter 10 Jahre;7082;3569;3513
05119;      Oberhausen, Kreisfreie Stadt;10 bis unter 15 Jahre;10235;5292;4943
05119;      Oberhausen, Kreisfreie Stadt;15 bis unter 18 Jahre;6641;3573;3068
05119;      Oberhausen, Kreisfreie Stadt;18 bis unter 20 Jahre;4873;2519;2354
05119;      Oberhausen, Kreisfreie Stadt;20 bis unter 25 Jahre;12707;6456;6251
05119;      Oberhausen, Kreisfreie Stadt;25 bis unter 30 Jahre;12093;5987;6106
05119;      Oberhausen, Kreisfreie Stadt;30 bis unter 35 Jahre;12527;6231;6296
05119;      Oberhausen, Kreisfreie Stadt;35 bis unter 40 Jahre;11975;6180;5795
05119;      Oberhausen, Kreisfreie Stadt;40 bis unter 45 Jahre;16037;8128;7909
05119;      Oberhausen, Kreisfreie Stadt;45 bis unter 50 Jahre;17937;9204;8733
05119;      Oberhausen, Kreisfreie Stadt;50 bis unter 55 Jahre;17281;8476;8805
05119;      Oberhausen, Kreisfreie Stadt;55 bis unter 60 Jahre;15465;7591;7874
05119;      Oberhausen, Kreisfreie Stadt;60 bis unter 65 Jahre;13547;6633;6914
05119;      Oberhausen, Kreisfreie Stadt;65 bis unter 75 Jahre;22856;10654;12202
05119;      Oberhausen, Kreisfreie Stadt;75 Jahre und mehr;21340;7934;13406
05119;      Oberhausen, Kreisfreie Stadt;Insgesamt;212568;103548;109020
05120;      Remscheid, Kreisfreie Stadt;unter 3 Jahre;2617;1348;1269
05120;      Remscheid, Kreisfreie Stadt;3 bis unter 6 Jahre;2820;1404;1416
05120;      Remscheid, Kreisfreie Stadt;6 bis unter 10 Jahre;4037;2064;1973
05120;      Remscheid, Kreisfreie Stadt;10 bis unter 15 Jahre;5674;2939;2735
05120;      Remscheid, Kreisfreie Stadt;15 bis unter 18 Jahre;3655;1869;1786
05120;      Remscheid, Kreisfreie Stadt;18 bis unter 20 Jahre;2601;1356;1245
05120;      Remscheid, Kreisfreie Stadt;20 bis unter 25 Jahre;6647;3377;3270
05120;      Remscheid, Kreisfreie Stadt;25 bis unter 30 Jahre;5906;3062;2844
05120;      Remscheid, Kreisfreie Stadt;30 bis unter 35 Jahre;6046;3090;2956
05120;      Remscheid, Kreisfreie Stadt;35 bis unter 40 Jahre;5800;2964;2836
05120;      Remscheid, Kreisfreie Stadt;40 bis unter 45 Jahre;8029;4035;3994
05120;      Remscheid, Kreisfreie Stadt;45 bis unter 50 Jahre;9244;4717;4527
05120;      Remscheid, Kreisfreie Stadt;50 bis unter 55 Jahre;8460;4184;4276
05120;      Remscheid, Kreisfreie Stadt;55 bis unter 60 Jahre;7126;3507;3619
05120;      Remscheid, Kreisfreie Stadt;60 bis unter 65 Jahre;6674;3229;3445
05120;      Remscheid, Kreisfreie Stadt;65 bis unter 75 Jahre;12959;6012;6947
05120;      Remscheid, Kreisfreie Stadt;75 Jahre und mehr;11301;4189;7112
05120;      Remscheid, Kreisfreie Stadt;Insgesamt;109596;53346;56250
05122;      Solingen, Kreisfreie Stadt;unter 3 Jahre;3790;1919;1871
05122;      Solingen, Kreisfreie Stadt;3 bis unter 6 Jahre;4093;2077;2016
05122;      Solingen, Kreisfreie Stadt;6 bis unter 10 Jahre;5692;2945;2747
05122;      Solingen, Kreisfreie Stadt;10 bis unter 15 Jahre;8029;4169;3860
05122;      Solingen, Kreisfreie Stadt;15 bis unter 18 Jahre;5200;2668;2532
05122;      Solingen, Kreisfreie Stadt;18 bis unter 20 Jahre;3672;1907;1765
05122;      Solingen, Kreisfreie Stadt;20 bis unter 25 Jahre;9041;4590;4451
05122;      Solingen, Kreisfreie Stadt;25 bis unter 30 Jahre;8761;4394;4367
05122;      Solingen, Kreisfreie Stadt;30 bis unter 35 Jahre;8672;4231;4441
05122;      Solingen, Kreisfreie Stadt;35 bis unter 40 Jahre;8836;4367;4469
05122;      Solingen, Kreisfreie Stadt;40 bis unter 45 Jahre;12638;6302;6336
05122;      Solingen, Kreisfreie Stadt;45 bis unter 50 Jahre;14493;7313;7180
05122;      Solingen, Kreisfreie Stadt;50 bis unter 55 Jahre;13046;6560;6486
05122;      Solingen, Kreisfreie Stadt;55 bis unter 60 Jahre;10239;5062;5177
05122;      Solingen, Kreisfreie Stadt;60 bis unter 65 Jahre;8817;4296;4521
05122;      Solingen, Kreisfreie Stadt;65 bis unter 75 Jahre;18082;8325;9757
05122;      Solingen, Kreisfreie Stadt;75 Jahre und mehr;16598;6284;10314
05122;      Solingen, Kreisfreie Stadt;Insgesamt;159699;77409;82290
05124;      Wuppertal, Kreisfreie Stadt;unter 3 Jahre;8640;4375;4265
05124;      Wuppertal, Kreisfreie Stadt;3 bis unter 6 Jahre;8808;4500;4308
05124;      Wuppertal, Kreisfreie Stadt;6 bis unter 10 Jahre;12029;6182;5847
05124;      Wuppertal, Kreisfreie Stadt;10 bis unter 15 Jahre;16458;8331;8127
05124;      Wuppertal, Kreisfreie Stadt;15 bis unter 18 Jahre;10293;5250;5043
05124;      Wuppertal, Kreisfreie Stadt;18 bis unter 20 Jahre;7700;3947;3753
05124;      Wuppertal, Kreisfreie Stadt;20 bis unter 25 Jahre;22577;11214;11363
05124;      Wuppertal, Kreisfreie Stadt;25 bis unter 30 Jahre;21701;10915;10786
05124;      Wuppertal, Kreisfreie Stadt;30 bis unter 35 Jahre;20411;10379;10032
05124;      Wuppertal, Kreisfreie Stadt;35 bis unter 40 Jahre;19728;9738;9990
05124;      Wuppertal, Kreisfreie Stadt;40 bis unter 45 Jahre;26435;13364;13071
05124;      Wuppertal, Kreisfreie Stadt;45 bis unter 50 Jahre;29914;15149;14765
05124;      Wuppertal, Kreisfreie Stadt;50 bis unter 55 Jahre;26858;13502;13356
05124;      Wuppertal, Kreisfreie Stadt;55 bis unter 60 Jahre;22336;10754;11582
05124;      Wuppertal, Kreisfreie Stadt;60 bis unter 65 Jahre;20745;10014;10731
05124;      Wuppertal, Kreisfreie Stadt;65 bis unter 75 Jahre;39441;18296;21145
05124;      Wuppertal, Kreisfreie Stadt;75 Jahre und mehr;35396;13089;22307
05124;      Wuppertal, Kreisfreie Stadt;Insgesamt;349470;168999;180471
05154;      Kleve, Kreis;unter 3 Jahre;7244;3808;3436
05154;      Kleve, Kreis;3 bis unter 6 Jahre;7776;4026;3750
05154;      Kleve, Kreis;6 bis unter 10 Jahre;11403;5783;5620
05154;      Kleve, Kreis;10 bis unter 15 Jahre;16609;8437;8172
05154;      Kleve, Kreis;15 bis unter 18 Jahre;10943;5604;5339
05154;      Kleve, Kreis;18 bis unter 20 Jahre;7743;3967;3776
05154;      Kleve, Kreis;20 bis unter 25 Jahre;18190;9461;8729
05154;      Kleve, Kreis;25 bis unter 30 Jahre;17016;8627;8389
05154;      Kleve, Kreis;30 bis unter 35 Jahre;16296;8319;7977
05154;      Kleve, Kreis;35 bis unter 40 Jahre;16996;8553;8443
05154;      Kleve, Kreis;40 bis unter 45 Jahre;25333;12900;12433
05154;      Kleve, Kreis;45 bis unter 50 Jahre;28213;14384;13829
05154;      Kleve, Kreis;50 bis unter 55 Jahre;25114;12839;12275
05154;      Kleve, Kreis;55 bis unter 60 Jahre;21662;10993;10669
05154;      Kleve, Kreis;60 bis unter 65 Jahre;18599;9332;9267
05154;      Kleve, Kreis;65 bis unter 75 Jahre;31441;15145;16296
05154;      Kleve, Kreis;75 Jahre und mehr;27507;10564;16943
05154;      Kleve, Kreis;Insgesamt;308085;152742;155343
05158;      Mettmann, Kreis;unter 3 Jahre;11232;5769;5463
05158;      Mettmann, Kreis;3 bis unter 6 Jahre;12333;6165;6168
05158;      Mettmann, Kreis;6 bis unter 10 Jahre;17244;8834;8410
05158;      Mettmann, Kreis;10 bis unter 15 Jahre;24308;12401;11907
05158;      Mettmann, Kreis;15 bis unter 18 Jahre;15275;7882;7393
05158;      Mettmann, Kreis;18 bis unter 20 Jahre;10368;5329;5039
05158;      Mettmann, Kreis;20 bis unter 25 Jahre;25535;13159;12376
05158;      Mettmann, Kreis;25 bis unter 30 Jahre;24204;12133;12071
05158;      Mettmann, Kreis;30 bis unter 35 Jahre;25093;12458;12635
05158;      Mettmann, Kreis;35 bis unter 40 Jahre;27541;13502;14039
05158;      Mettmann, Kreis;40 bis unter 45 Jahre;39201;19482;19719
05158;      Mettmann, Kreis;45 bis unter 50 Jahre;43853;21934;21919
05158;      Mettmann, Kreis;50 bis unter 55 Jahre;39598;19483;20115
05158;      Mettmann, Kreis;55 bis unter 60 Jahre;33623;16338;17285
05158;      Mettmann, Kreis;60 bis unter 65 Jahre;30879;14656;16223
05158;      Mettmann, Kreis;65 bis unter 75 Jahre;62490;28931;33559
05158;      Mettmann, Kreis;75 Jahre und mehr;51680;20642;31038
05158;      Mettmann, Kreis;Insgesamt;494457;239098;255359
05162;      Rhein-Kreis Neuss;unter 3 Jahre;10984;5594;5390
05162;      Rhein-Kreis Neuss;3 bis unter 6 Jahre;11721;5960;5761
05162;      Rhein-Kreis Neuss;6 bis unter 10 Jahre;16447;8554;7893
05162;      Rhein-Kreis Neuss;10 bis unter 15 Jahre;22868;11696;11172
05162;      Rhein-Kreis Neuss;15 bis unter 18 Jahre;14092;7184;6908
05162;      Rhein-Kreis Neuss;18 bis unter 20 Jahre;9678;5012;4666
05162;      Rhein-Kreis Neuss;20 bis unter 25 Jahre;23533;12001;11532
05162;      Rhein-Kreis Neuss;25 bis unter 30 Jahre;22766;11410;11356
05162;      Rhein-Kreis Neuss;30 bis unter 35 Jahre;24534;12059;12475
05162;      Rhein-Kreis Neuss;35 bis unter 40 Jahre;25558;12507;13051
05162;      Rhein-Kreis Neuss;40 bis unter 45 Jahre;36141;18115;18026
05162;      Rhein-Kreis Neuss;45 bis unter 50 Jahre;40030;20202;19828
05162;      Rhein-Kreis Neuss;50 bis unter 55 Jahre;35383;17518;17865
05162;      Rhein-Kreis Neuss;55 bis unter 60 Jahre;30395;14867;15528
05162;      Rhein-Kreis Neuss;60 bis unter 65 Jahre;27138;12949;14189
05162;      Rhein-Kreis Neuss;65 bis unter 75 Jahre;50890;23858;27032
05162;      Rhein-Kreis Neuss;75 Jahre und mehr;41692;16693;24999
05162;      Rhein-Kreis Neuss;Insgesamt;443850;216179;227671
05166;      Viersen, Kreis;unter 3 Jahre;6674;3425;3249
05166;      Viersen, Kreis;3 bis unter 6 Jahre;7272;3686;3586
05166;      Viersen, Kreis;6 bis unter 10 Jahre;10727;5481;5246
05166;      Viersen, Kreis;10 bis unter 15 Jahre;16118;8231;7887
05166;      Viersen, Kreis;15 bis unter 18 Jahre;10835;5518;5317
05166;      Viersen, Kreis;18 bis unter 20 Jahre;7525;3928;3597
05166;      Viersen, Kreis;20 bis unter 25 Jahre;16367;8505;7862
05166;      Viersen, Kreis;25 bis unter 30 Jahre;14402;7258;7144
05166;      Viersen, Kreis;30 bis unter 35 Jahre;14703;7129;7574
05166;      Viersen, Kreis;35 bis unter 40 Jahre;16110;7624;8486
05166;      Viersen, Kreis;40 bis unter 45 Jahre;24881;12265;12616
05166;      Viersen, Kreis;45 bis unter 50 Jahre;28564;14393;14171
05166;      Viersen, Kreis;50 bis unter 55 Jahre;25151;12684;12467
05166;      Viersen, Kreis;55 bis unter 60 Jahre;20901;10438;10463
05166;      Viersen, Kreis;60 bis unter 65 Jahre;18147;8797;9350
05166;      Viersen, Kreis;65 bis unter 75 Jahre;33208;15651;17557
05166;      Viersen, Kreis;75 Jahre und mehr;28257;11023;17234
05166;      Viersen, Kreis;Insgesamt;299842;146036;153806
05170;      Wesel, Kreis;unter 3 Jahre;10184;5160;5024
05170;      Wesel, Kreis;3 bis unter 6 Jahre;10866;5644;5222
05170;      Wesel, Kreis;6 bis unter 10 Jahre;15990;8210;7780
05170;      Wesel, Kreis;10 bis unter 15 Jahre;23130;11804;11326
05170;      Wesel, Kreis;15 bis unter 18 Jahre;15298;7818;7480
05170;      Wesel, Kreis;18 bis unter 20 Jahre;11079;5809;5270
05170;      Wesel, Kreis;20 bis unter 25 Jahre;26557;13852;12705
05170;      Wesel, Kreis;25 bis unter 30 Jahre;23446;11812;11634
05170;      Wesel, Kreis;30 bis unter 35 Jahre;23865;11604;12261
05170;      Wesel, Kreis;35 bis unter 40 Jahre;24637;11980;12657
05170;      Wesel, Kreis;40 bis unter 45 Jahre;36844;17994;18850
05170;      Wesel, Kreis;45 bis unter 50 Jahre;42180;20877;21303
05170;      Wesel, Kreis;50 bis unter 55 Jahre;39490;19518;19972
05170;      Wesel, Kreis;55 bis unter 60 Jahre;34806;17121;17685
05170;      Wesel, Kreis;60 bis unter 65 Jahre;29767;14562;15205
05170;      Wesel, Kreis;65 bis unter 75 Jahre;52306;24576;27730
05170;      Wesel, Kreis;75 Jahre und mehr;46829;18491;28338
05170;      Wesel, Kreis;Insgesamt;467274;226832;240442
053;    Köln, Regierungsbezirk;unter 3 Jahre;112566;57853;54713
053;    Köln, Regierungsbezirk;3 bis unter 6 Jahre;114808;59083;55725
053;    Köln, Regierungsbezirk;6 bis unter 10 Jahre;157582;80967;76615
053;    Köln, Regierungsbezirk;10 bis unter 15 Jahre;219441;111928;107513
053;    Köln, Regierungsbezirk;15 bis unter 18 Jahre;135972;69803;66169
053;    Köln, Regierungsbezirk;18 bis unter 20 Jahre;98666;50722;47944
053;    Köln, Regierungsbezirk;20 bis unter 25 Jahre;278439;142198;136241
053;    Köln, Regierungsbezirk;25 bis unter 30 Jahre;277413;139013;138400
053;    Köln, Regierungsbezirk;30 bis unter 35 Jahre;273568;135449;138119
053;    Köln, Regierungsbezirk;35 bis unter 40 Jahre;264490;131487;133003
053;    Köln, Regierungsbezirk;40 bis unter 45 Jahre;349068;175119;173949
053;    Köln, Regierungsbezirk;45 bis unter 50 Jahre;390765;198591;192174
053;    Köln, Regierungsbezirk;50 bis unter 55 Jahre;342487;173054;169433
053;    Köln, Regierungsbezirk;55 bis unter 60 Jahre;284328;139787;144541
053;    Köln, Regierungsbezirk;60 bis unter 65 Jahre;250378;121429;128949
053;    Köln, Regierungsbezirk;65 bis unter 75 Jahre;460510;217758;242752
053;    Köln, Regierungsbezirk;75 Jahre und mehr;396794;156232;240562
053;    Köln, Regierungsbezirk;Insgesamt;4407275;2160473;2246802
05314;      Bonn, Kreisfreie Stadt;unter 3 Jahre;9595;4986;4609
05314;      Bonn, Kreisfreie Stadt;3 bis unter 6 Jahre;9130;4702;4428
05314;      Bonn, Kreisfreie Stadt;6 bis unter 10 Jahre;11646;6058;5588
05314;      Bonn, Kreisfreie Stadt;10 bis unter 15 Jahre;14784;7524;7260
05314;      Bonn, Kreisfreie Stadt;15 bis unter 18 Jahre;8643;4456;4187
05314;      Bonn, Kreisfreie Stadt;18 bis unter 20 Jahre;6644;3291;3353
05314;      Bonn, Kreisfreie Stadt;20 bis unter 25 Jahre;23106;10717;12389
05314;      Bonn, Kreisfreie Stadt;25 bis unter 30 Jahre;25735;12269;13466
05314;      Bonn, Kreisfreie Stadt;30 bis unter 35 Jahre;23868;11755;12113
05314;      Bonn, Kreisfreie Stadt;35 bis unter 40 Jahre;20986;10487;10499
05314;      Bonn, Kreisfreie Stadt;40 bis unter 45 Jahre;24525;12369;12156
05314;      Bonn, Kreisfreie Stadt;45 bis unter 50 Jahre;29206;14422;14784
05314;      Bonn, Kreisfreie Stadt;50 bis unter 55 Jahre;24751;12387;12364
05314;      Bonn, Kreisfreie Stadt;55 bis unter 60 Jahre;19513;9699;9814
05314;      Bonn, Kreisfreie Stadt;60 bis unter 65 Jahre;16200;7737;8463
05314;      Bonn, Kreisfreie Stadt;65 bis unter 75 Jahre;30388;13833;16555
05314;      Bonn, Kreisfreie Stadt;75 Jahre und mehr;29193;10826;18367
05314;      Bonn, Kreisfreie Stadt;Insgesamt;327913;157518;170395
05315;      Köln, Kreisfreie Stadt;unter 3 Jahre;29298;15008;14290
05315;      Köln, Kreisfreie Stadt;3 bis unter 6 Jahre;27478;14149;13329
05315;      Köln, Kreisfreie Stadt;6 bis unter 10 Jahre;33773;17219;16554
05315;      Köln, Kreisfreie Stadt;10 bis unter 15 Jahre;43013;21884;21129
05315;      Köln, Kreisfreie Stadt;15 bis unter 18 Jahre;25579;13217;12362
05315;      Köln, Kreisfreie Stadt;18 bis unter 20 Jahre;19012;9593;9419
05315;      Köln, Kreisfreie Stadt;20 bis unter 25 Jahre;68943;32378;36565
05315;      Köln, Kreisfreie Stadt;25 bis unter 30 Jahre;82630;39123;43507
05315;      Köln, Kreisfreie Stadt;30 bis unter 35 Jahre;82955;40375;42580
05315;      Köln, Kreisfreie Stadt;35 bis unter 40 Jahre;72730;36697;36033
05315;      Köln, Kreisfreie Stadt;40 bis unter 45 Jahre;81672;41872;39800
05315;      Köln, Kreisfreie Stadt;45 bis unter 50 Jahre;85045;43440;41605
05315;      Köln, Kreisfreie Stadt;50 bis unter 55 Jahre;70333;35337;34996
05315;      Köln, Kreisfreie Stadt;55 bis unter 60 Jahre;57998;27783;30215
05315;      Köln, Kreisfreie Stadt;60 bis unter 65 Jahre;52657;24940;27717
05315;      Köln, Kreisfreie Stadt;65 bis unter 75 Jahre;99943;47105;52838
05315;      Köln, Kreisfreie Stadt;75 Jahre und mehr;84096;32296;51800
05315;      Köln, Kreisfreie Stadt;Insgesamt;1017155;492416;524739
05316;      Leverkusen, Kreisfreie Stadt;unter 3 Jahre;4049;2085;1964
05316;      Leverkusen, Kreisfreie Stadt;3 bis unter 6 Jahre;4334;2247;2087
05316;      Leverkusen, Kreisfreie Stadt;6 bis unter 10 Jahre;5829;2993;2836
05316;      Leverkusen, Kreisfreie Stadt;10 bis unter 15 Jahre;7811;3998;3813
05316;      Leverkusen, Kreisfreie Stadt;15 bis unter 18 Jahre;4867;2553;2314
05316;      Leverkusen, Kreisfreie Stadt;18 bis unter 20 Jahre;3364;1661;1703
05316;      Leverkusen, Kreisfreie Stadt;20 bis unter 25 Jahre;9129;4578;4551
05316;      Leverkusen, Kreisfreie Stadt;25 bis unter 30 Jahre;9255;4571;4684
05316;      Leverkusen, Kreisfreie Stadt;30 bis unter 35 Jahre;9100;4551;4549
05316;      Leverkusen, Kreisfreie Stadt;35 bis unter 40 Jahre;8981;4495;4486
05316;      Leverkusen, Kreisfreie Stadt;40 bis unter 45 Jahre;12761;6434;6327
05316;      Leverkusen, Kreisfreie Stadt;45 bis unter 50 Jahre;14149;7126;7023
05316;      Leverkusen, Kreisfreie Stadt;50 bis unter 55 Jahre;12445;6252;6193
05316;      Leverkusen, Kreisfreie Stadt;55 bis unter 60 Jahre;10107;4820;5287
05316;      Leverkusen, Kreisfreie Stadt;60 bis unter 65 Jahre;8965;4236;4729
05316;      Leverkusen, Kreisfreie Stadt;65 bis unter 75 Jahre;18857;8729;10128
05316;      Leverkusen, Kreisfreie Stadt;75 Jahre und mehr;17192;6832;10360
05316;      Leverkusen, Kreisfreie Stadt;Insgesamt;161195;78161;83034
05334;      Städteregion Aachen (einschl. Stadt Aachen);unter 3 Jahre;13020;6676;6344
05334;      Städteregion Aachen (einschl. Stadt Aachen);3 bis unter 6 Jahre;13601;7027;6574
05334;      Städteregion Aachen (einschl. Stadt Aachen);6 bis unter 10 Jahre;19065;9688;9377
05334;      Städteregion Aachen (einschl. Stadt Aachen);10 bis unter 15 Jahre;26570;13582;12988
05334;      Städteregion Aachen (einschl. Stadt Aachen);15 bis unter 18 Jahre;16780;8600;8180
05334;      Städteregion Aachen (einschl. Stadt Aachen);18 bis unter 20 Jahre;13352;7062;6290
05334;      Städteregion Aachen (einschl. Stadt Aachen);20 bis unter 25 Jahre;44817;25392;19425
05334;      Städteregion Aachen (einschl. Stadt Aachen);25 bis unter 30 Jahre;40394;22013;18381
05334;      Städteregion Aachen (einschl. Stadt Aachen);30 bis unter 35 Jahre;34178;17721;16457
05334;      Städteregion Aachen (einschl. Stadt Aachen);35 bis unter 40 Jahre;31183;15661;15522
05334;      Städteregion Aachen (einschl. Stadt Aachen);40 bis unter 45 Jahre;41499;20778;20721
05334;      Städteregion Aachen (einschl. Stadt Aachen);45 bis unter 50 Jahre;50665;26926;23739
05334;      Städteregion Aachen (einschl. Stadt Aachen);50 bis unter 55 Jahre;44741;23511;21230
05334;      Städteregion Aachen (einschl. Stadt Aachen);55 bis unter 60 Jahre;36199;18095;18104
05334;      Städteregion Aachen (einschl. Stadt Aachen);60 bis unter 65 Jahre;31987;15664;16323
05334;      Städteregion Aachen (einschl. Stadt Aachen);65 bis unter 75 Jahre;57058;26775;30283
05334;      Städteregion Aachen (einschl. Stadt Aachen);75 Jahre und mehr;51707;20136;31571
05334;      Städteregion Aachen (einschl. Stadt Aachen);Insgesamt;566816;285307;281509
05334002;      Aachen, krfr. Stadt;unter 3 Jahre;5794;2972;2822
05334002;      Aachen, krfr. Stadt;3 bis unter 6 Jahre;5741;2926;2815
05334002;      Aachen, krfr. Stadt;6 bis unter 10 Jahre;7584;3873;3711
05334002;      Aachen, krfr. Stadt;10 bis unter 15 Jahre;9814;5009;4805
05334002;      Aachen, krfr. Stadt;15 bis unter 18 Jahre;6284;3140;3144
05334002;      Aachen, krfr. Stadt;18 bis unter 20 Jahre;5882;3252;2630
05334002;      Aachen, krfr. Stadt;20 bis unter 25 Jahre;27137;16043;11094
05334002;      Aachen, krfr. Stadt;25 bis unter 30 Jahre;24441;13912;10529
05334002;      Aachen, krfr. Stadt;30 bis unter 35 Jahre;17647;9555;8092
05334002;      Aachen, krfr. Stadt;35 bis unter 40 Jahre;13927;7190;6737
05334002;      Aachen, krfr. Stadt;40 bis unter 45 Jahre;17171;8609;8562
05334002;      Aachen, krfr. Stadt;45 bis unter 50 Jahre;23976;13370;10606
05334002;      Aachen, krfr. Stadt;50 bis unter 55 Jahre;20262;11132;9130
05334002;      Aachen, krfr. Stadt;55 bis unter 60 Jahre;15094;7617;7477
05334002;      Aachen, krfr. Stadt;60 bis unter 65 Jahre;13204;6526;6678
05334002;      Aachen, krfr. Stadt;65 bis unter 75 Jahre;24098;11173;12925
05334002;      Aachen, krfr. Stadt;75 Jahre und mehr;22398;8699;13699
05334002;      Aachen, krfr. Stadt;Insgesamt;260454;134998;125456
05358;      Düren, Kreis;unter 3 Jahre;6172;3220;2952
05358;      Düren, Kreis;3 bis unter 6 Jahre;6597;3472;3125
05358;      Düren, Kreis;6 bis unter 10 Jahre;9405;4835;4570
05358;      Düren, Kreis;10 bis unter 15 Jahre;14273;7312;6961
05358;      Düren, Kreis;15 bis unter 18 Jahre;9179;4739;4440
05358;      Düren, Kreis;18 bis unter 20 Jahre;6803;3571;3232
05358;      Düren, Kreis;20 bis unter 25 Jahre;16195;8601;7594
05358;      Düren, Kreis;25 bis unter 30 Jahre;14324;7467;6857
05358;      Düren, Kreis;30 bis unter 35 Jahre;14644;7469;7175
05358;      Düren, Kreis;35 bis unter 40 Jahre;15172;7781;7391
05358;      Düren, Kreis;40 bis unter 45 Jahre;21428;11007;10421
05358;      Düren, Kreis;45 bis unter 50 Jahre;23997;12474;11523
05358;      Düren, Kreis;50 bis unter 55 Jahre;21751;11022;10729
05358;      Düren, Kreis;55 bis unter 60 Jahre;18903;9390;9513
05358;      Düren, Kreis;60 bis unter 65 Jahre;16310;8125;8185
05358;      Düren, Kreis;65 bis unter 75 Jahre;27464;13174;14290
05358;      Düren, Kreis;75 Jahre und mehr;24487;9643;14844
05358;      Düren, Kreis;Insgesamt;267104;133302;133802
05362;      Rhein-Erft-Kreis;unter 3 Jahre;11578;5892;5686
05362;      Rhein-Erft-Kreis;3 bis unter 6 Jahre;12122;6163;5959
05362;      Rhein-Erft-Kreis;6 bis unter 10 Jahre;16922;8689;8233
05362;      Rhein-Erft-Kreis;10 bis unter 15 Jahre;24101;12185;11916
05362;      Rhein-Erft-Kreis;15 bis unter 18 Jahre;14652;7425;7227
05362;      Rhein-Erft-Kreis;18 bis unter 20 Jahre;10229;5266;4963
05362;      Rhein-Erft-Kreis;20 bis unter 25 Jahre;25997;13374;12623
05362;      Rhein-Erft-Kreis;25 bis unter 30 Jahre;24501;12321;12180
05362;      Rhein-Erft-Kreis;30 bis unter 35 Jahre;25503;12679;12824
05362;      Rhein-Erft-Kreis;35 bis unter 40 Jahre;27006;13174;13832
05362;      Rhein-Erft-Kreis;40 bis unter 45 Jahre;38864;19320;19544
05362;      Rhein-Erft-Kreis;45 bis unter 50 Jahre;42543;21545;20998
05362;      Rhein-Erft-Kreis;50 bis unter 55 Jahre;37294;18794;18500
05362;      Rhein-Erft-Kreis;55 bis unter 60 Jahre;31798;15560;16238
05362;      Rhein-Erft-Kreis;60 bis unter 65 Jahre;29072;14053;15019
05362;      Rhein-Erft-Kreis;65 bis unter 75 Jahre;51652;24616;27036
05362;      Rhein-Erft-Kreis;75 Jahre und mehr;41744;16938;24806
05362;      Rhein-Erft-Kreis;Insgesamt;465578;227994;237584
05366;      Euskirchen, Kreis;unter 3 Jahre;4337;2251;2086
05366;      Euskirchen, Kreis;3 bis unter 6 Jahre;4757;2453;2304
05366;      Euskirchen, Kreis;6 bis unter 10 Jahre;7023;3583;3440
05366;      Euskirchen, Kreis;10 bis unter 15 Jahre;10636;5450;5186
05366;      Euskirchen, Kreis;15 bis unter 18 Jahre;6718;3477;3241
05366;      Euskirchen, Kreis;18 bis unter 20 Jahre;4746;2474;2272
05366;      Euskirchen, Kreis;20 bis unter 25 Jahre;10609;5523;5086
05366;      Euskirchen, Kreis;25 bis unter 30 Jahre;9338;4834;4504
05366;      Euskirchen, Kreis;30 bis unter 35 Jahre;9632;4818;4814
05366;      Euskirchen, Kreis;35 bis unter 40 Jahre;10294;5060;5234
05366;      Euskirchen, Kreis;40 bis unter 45 Jahre;15078;7580;7498
05366;      Euskirchen, Kreis;45 bis unter 50 Jahre;17426;8721;8705
05366;      Euskirchen, Kreis;50 bis unter 55 Jahre;16199;8195;8004
05366;      Euskirchen, Kreis;55 bis unter 60 Jahre;13706;6908;6798
05366;      Euskirchen, Kreis;60 bis unter 65 Jahre;12007;6043;5964
05366;      Euskirchen, Kreis;65 bis unter 75 Jahre;20236;9721;10515
05366;      Euskirchen, Kreis;75 Jahre und mehr;17849;6991;10858
05366;      Euskirchen, Kreis;Insgesamt;190591;94082;96509
05370;      Heinsberg, Kreis;unter 3 Jahre;6055;3022;3033
05370;      Heinsberg, Kreis;3 bis unter 6 Jahre;6341;3316;3025
05370;      Heinsberg, Kreis;6 bis unter 10 Jahre;9499;4901;4598
05370;      Heinsberg, Kreis;10 bis unter 15 Jahre;14255;7277;6978
05370;      Heinsberg, Kreis;15 bis unter 18 Jahre;9177;4679;4498
05370;      Heinsberg, Kreis;18 bis unter 20 Jahre;6746;3491;3255
05370;      Heinsberg, Kreis;20 bis unter 25 Jahre;15149;7995;7154
05370;      Heinsberg, Kreis;25 bis unter 30 Jahre;13359;6741;6618
05370;      Heinsberg, Kreis;30 bis unter 35 Jahre;13528;6633;6895
05370;      Heinsberg, Kreis;35 bis unter 40 Jahre;14193;6981;7212
05370;      Heinsberg, Kreis;40 bis unter 45 Jahre;20340;10109;10231
05370;      Heinsberg, Kreis;45 bis unter 50 Jahre;23130;11747;11383
05370;      Heinsberg, Kreis;50 bis unter 55 Jahre;21373;10831;10542
05370;      Heinsberg, Kreis;55 bis unter 60 Jahre;18115;9165;8950
05370;      Heinsberg, Kreis;60 bis unter 65 Jahre;15046;7518;7528
05370;      Heinsberg, Kreis;65 bis unter 75 Jahre;25657;12324;13333
05370;      Heinsberg, Kreis;75 Jahre und mehr;22823;8942;13881
05370;      Heinsberg, Kreis;Insgesamt;254786;125672;129114
05374;      Oberbergischer Kreis;unter 3 Jahre;6875;3475;3400
05374;      Oberbergischer Kreis;3 bis unter 6 Jahre;7258;3704;3554
05374;      Oberbergischer Kreis;6 bis unter 10 Jahre;10807;5541;5266
05374;      Oberbergischer Kreis;10 bis unter 15 Jahre;15934;7975;7959
05374;      Oberbergischer Kreis;15 bis unter 18 Jahre;10114;5176;4938
05374;      Oberbergischer Kreis;18 bis unter 20 Jahre;7192;3722;3470
05374;      Oberbergischer Kreis;20 bis unter 25 Jahre;16514;8691;7823
05374;      Oberbergischer Kreis;25 bis unter 30 Jahre;15101;7868;7233
05374;      Oberbergischer Kreis;30 bis unter 35 Jahre;15223;7663;7560
05374;      Oberbergischer Kreis;35 bis unter 40 Jahre;15560;7657;7903
05374;      Oberbergischer Kreis;40 bis unter 45 Jahre;21377;10518;10859
05374;      Oberbergischer Kreis;45 bis unter 50 Jahre;24400;12364;12036
05374;      Oberbergischer Kreis;50 bis unter 55 Jahre;22380;11206;11174
05374;      Oberbergischer Kreis;55 bis unter 60 Jahre;18676;9200;9476
05374;      Oberbergischer Kreis;60 bis unter 65 Jahre;15914;7957;7957
05374;      Oberbergischer Kreis;65 bis unter 75 Jahre;29334;13848;15486
05374;      Oberbergischer Kreis;75 Jahre und mehr;26873;10371;16502
05374;      Oberbergischer Kreis;Insgesamt;279532;136936;142596
05378;      Rheinisch-Bergischer Kreis;unter 3 Jahre;6638;3426;3212
05378;      Rheinisch-Bergischer Kreis;3 bis unter 6 Jahre;7170;3651;3519
05378;      Rheinisch-Bergischer Kreis;6 bis unter 10 Jahre;10668;5526;5142
05378;      Rheinisch-Bergischer Kreis;10 bis unter 15 Jahre;14979;7757;7222
05378;      Rheinisch-Bergischer Kreis;15 bis unter 18 Jahre;9468;4825;4643
05378;      Rheinisch-Bergischer Kreis;18 bis unter 20 Jahre;6312;3265;3047
05378;      Rheinisch-Bergischer Kreis;20 bis unter 25 Jahre;14109;7355;6754
05378;      Rheinisch-Bergischer Kreis;25 bis unter 30 Jahre;12304;6267;6037
05378;      Rheinisch-Bergischer Kreis;30 bis unter 35 Jahre;12741;6272;6469
05378;      Rheinisch-Bergischer Kreis;35 bis unter 40 Jahre;14440;6876;7564
05378;      Rheinisch-Bergischer Kreis;40 bis unter 45 Jahre;22513;10959;11554
05378;      Rheinisch-Bergischer Kreis;45 bis unter 50 Jahre;25549;12534;13015
05378;      Rheinisch-Bergischer Kreis;50 bis unter 55 Jahre;22397;11083;11314
05378;      Rheinisch-Bergischer Kreis;55 bis unter 60 Jahre;18461;9016;9445
05378;      Rheinisch-Bergischer Kreis;60 bis unter 65 Jahre;16618;7919;8699
05378;      Rheinisch-Bergischer Kreis;65 bis unter 75 Jahre;33414;15684;17730
05378;      Rheinisch-Bergischer Kreis;75 Jahre und mehr;28392;11772;16620
05378;      Rheinisch-Bergischer Kreis;Insgesamt;276173;134187;141986
05382;      Rhein-Sieg-Kreis;unter 3 Jahre;14949;7812;7137
05382;      Rhein-Sieg-Kreis;3 bis unter 6 Jahre;16020;8199;7821
05382;      Rhein-Sieg-Kreis;6 bis unter 10 Jahre;22945;11934;11011
05382;      Rhein-Sieg-Kreis;10 bis unter 15 Jahre;33085;16984;16101
05382;      Rhein-Sieg-Kreis;15 bis unter 18 Jahre;20795;10656;10139
05382;      Rhein-Sieg-Kreis;18 bis unter 20 Jahre;14266;7326;6940
05382;      Rhein-Sieg-Kreis;20 bis unter 25 Jahre;33871;17594;16277
05382;      Rhein-Sieg-Kreis;25 bis unter 30 Jahre;30472;15539;14933
05382;      Rhein-Sieg-Kreis;30 bis unter 35 Jahre;32196;15513;16683
05382;      Rhein-Sieg-Kreis;35 bis unter 40 Jahre;33945;16618;17327
05382;      Rhein-Sieg-Kreis;40 bis unter 45 Jahre;49011;24173;24838
05382;      Rhein-Sieg-Kreis;45 bis unter 50 Jahre;54655;27292;27363
05382;      Rhein-Sieg-Kreis;50 bis unter 55 Jahre;48823;24436;24387
05382;      Rhein-Sieg-Kreis;55 bis unter 60 Jahre;40852;20151;20701
05382;      Rhein-Sieg-Kreis;60 bis unter 65 Jahre;35602;17237;18365
05382;      Rhein-Sieg-Kreis;65 bis unter 75 Jahre;66507;31949;34558
05382;      Rhein-Sieg-Kreis;75 Jahre und mehr;52438;21485;30953
05382;      Rhein-Sieg-Kreis;Insgesamt;600432;294898;305534
055;    Münster, Regierungsbezirk;unter 3 Jahre;63393;32429;30964
055;    Münster, Regierungsbezirk;3 bis unter 6 Jahre;67127;34412;32715
055;    Münster, Regierungsbezirk;6 bis unter 10 Jahre;96531;49509;47022
055;    Münster, Regierungsbezirk;10 bis unter 15 Jahre;141575;72627;68948
055;    Münster, Regierungsbezirk;15 bis unter 18 Jahre;89761;46085;43676
055;    Münster, Regierungsbezirk;18 bis unter 20 Jahre;64823;33330;31493
055;    Münster, Regierungsbezirk;20 bis unter 25 Jahre;166536;85016;81520
055;    Münster, Regierungsbezirk;25 bis unter 30 Jahre;151550;77386;74164
055;    Münster, Regierungsbezirk;30 bis unter 35 Jahre;145146;72894;72252
055;    Münster, Regierungsbezirk;35 bis unter 40 Jahre;151224;75730;75494
055;    Münster, Regierungsbezirk;40 bis unter 45 Jahre;206575;103997;102578
055;    Münster, Regierungsbezirk;45 bis unter 50 Jahre;226482;114389;112093
055;    Münster, Regierungsbezirk;50 bis unter 55 Jahre;203786;101504;102282
055;    Münster, Regierungsbezirk;55 bis unter 60 Jahre;174685;86233;88452
055;    Münster, Regierungsbezirk;60 bis unter 65 Jahre;148021;73216;74805
055;    Münster, Regierungsbezirk;65 bis unter 75 Jahre;259553;121953;137600
055;    Münster, Regierungsbezirk;75 Jahre und mehr;240846;89718;151128
055;    Münster, Regierungsbezirk;Insgesamt;2597614;1270428;1327186
05512;      Bottrop, Kreisfreie Stadt;unter 3 Jahre;2557;1345;1212
05512;      Bottrop, Kreisfreie Stadt;3 bis unter 6 Jahre;2688;1347;1341
05512;      Bottrop, Kreisfreie Stadt;6 bis unter 10 Jahre;3920;1983;1937
05512;      Bottrop, Kreisfreie Stadt;10 bis unter 15 Jahre;5740;2936;2804
05512;      Bottrop, Kreisfreie Stadt;15 bis unter 18 Jahre;3642;1878;1764
05512;      Bottrop, Kreisfreie Stadt;18 bis unter 20 Jahre;2618;1387;1231
05512;      Bottrop, Kreisfreie Stadt;20 bis unter 25 Jahre;6810;3513;3297
05512;      Bottrop, Kreisfreie Stadt;25 bis unter 30 Jahre;6240;3108;3132
05512;      Bottrop, Kreisfreie Stadt;30 bis unter 35 Jahre;6427;3276;3151
05512;      Bottrop, Kreisfreie Stadt;35 bis unter 40 Jahre;6541;3338;3203
05512;      Bottrop, Kreisfreie Stadt;40 bis unter 45 Jahre;9039;4529;4510
05512;      Bottrop, Kreisfreie Stadt;45 bis unter 50 Jahre;9931;4903;5028
05512;      Bottrop, Kreisfreie Stadt;50 bis unter 55 Jahre;9701;4744;4957
05512;      Bottrop, Kreisfreie Stadt;55 bis unter 60 Jahre;8547;4190;4357
05512;      Bottrop, Kreisfreie Stadt;60 bis unter 65 Jahre;7484;3626;3858
05512;      Bottrop, Kreisfreie Stadt;65 bis unter 75 Jahre;12535;5787;6748
05512;      Bottrop, Kreisfreie Stadt;75 Jahre und mehr;11941;4280;7661
05512;      Bottrop, Kreisfreie Stadt;Insgesamt;116361;56170;60191
05513;      Gelsenkirchen, Kreisfreie Stadt;unter 3 Jahre;6278;3216;3062
05513;      Gelsenkirchen, Kreisfreie Stadt;3 bis unter 6 Jahre;6514;3346;3168
05513;      Gelsenkirchen, Kreisfreie Stadt;6 bis unter 10 Jahre;8892;4594;4298
05513;      Gelsenkirchen, Kreisfreie Stadt;10 bis unter 15 Jahre;12708;6475;6233
05513;      Gelsenkirchen, Kreisfreie Stadt;15 bis unter 18 Jahre;8032;4148;3884
05513;      Gelsenkirchen, Kreisfreie Stadt;18 bis unter 20 Jahre;5968;3025;2943
05513;      Gelsenkirchen, Kreisfreie Stadt;20 bis unter 25 Jahre;16393;8534;7859
05513;      Gelsenkirchen, Kreisfreie Stadt;25 bis unter 30 Jahre;14788;7566;7222
05513;      Gelsenkirchen, Kreisfreie Stadt;30 bis unter 35 Jahre;14637;7342;7295
05513;      Gelsenkirchen, Kreisfreie Stadt;35 bis unter 40 Jahre;15162;7710;7452
05513;      Gelsenkirchen, Kreisfreie Stadt;40 bis unter 45 Jahre;19559;10045;9514
05513;      Gelsenkirchen, Kreisfreie Stadt;45 bis unter 50 Jahre;20736;10648;10088
05513;      Gelsenkirchen, Kreisfreie Stadt;50 bis unter 55 Jahre;20076;10092;9984
05513;      Gelsenkirchen, Kreisfreie Stadt;55 bis unter 60 Jahre;17921;8782;9139
05513;      Gelsenkirchen, Kreisfreie Stadt;60 bis unter 65 Jahre;15366;7636;7730
05513;      Gelsenkirchen, Kreisfreie Stadt;65 bis unter 75 Jahre;26939;12517;14422
05513;      Gelsenkirchen, Kreisfreie Stadt;75 Jahre und mehr;26683;9387;17296
05513;      Gelsenkirchen, Kreisfreie Stadt;Insgesamt;256652;125063;131589
05515;      Münster, Kreisfreie Stadt;unter 3 Jahre;7766;3996;3770
05515;      Münster, Kreisfreie Stadt;3 bis unter 6 Jahre;7220;3711;3509
05515;      Münster, Kreisfreie Stadt;6 bis unter 10 Jahre;9120;4670;4450
05515;      Münster, Kreisfreie Stadt;10 bis unter 15 Jahre;12326;6322;6004
05515;      Münster, Kreisfreie Stadt;15 bis unter 18 Jahre;7521;3738;3783
05515;      Münster, Kreisfreie Stadt;18 bis unter 20 Jahre;6484;3087;3397
05515;      Münster, Kreisfreie Stadt;20 bis unter 25 Jahre;28361;12425;15936
05515;      Münster, Kreisfreie Stadt;25 bis unter 30 Jahre;27556;13184;14372
05515;      Münster, Kreisfreie Stadt;30 bis unter 35 Jahre;21143;10375;10768
05515;      Münster, Kreisfreie Stadt;35 bis unter 40 Jahre;17875;8938;8937
05515;      Münster, Kreisfreie Stadt;40 bis unter 45 Jahre;22389;10728;11661
05515;      Münster, Kreisfreie Stadt;45 bis unter 50 Jahre;25282;12173;13109
05515;      Münster, Kreisfreie Stadt;50 bis unter 55 Jahre;19918;9639;10279
05515;      Münster, Kreisfreie Stadt;55 bis unter 60 Jahre;16258;7760;8498
05515;      Münster, Kreisfreie Stadt;60 bis unter 65 Jahre;13191;6245;6946
05515;      Münster, Kreisfreie Stadt;65 bis unter 75 Jahre;25076;11164;13912
05515;      Münster, Kreisfreie Stadt;75 Jahre und mehr;24268;8647;15621
05515;      Münster, Kreisfreie Stadt;Insgesamt;291754;136802;154952
05554;      Borken, Kreis;unter 3 Jahre;9821;4919;4902
05554;      Borken, Kreis;3 bis unter 6 Jahre;10450;5356;5094
05554;      Borken, Kreis;6 bis unter 10 Jahre;15470;7885;7585
05554;      Borken, Kreis;10 bis unter 15 Jahre;22748;11703;11045
05554;      Borken, Kreis;15 bis unter 18 Jahre;14681;7597;7084
05554;      Borken, Kreis;18 bis unter 20 Jahre;10334;5426;4908
05554;      Borken, Kreis;20 bis unter 25 Jahre;23455;12435;11020
05554;      Borken, Kreis;25 bis unter 30 Jahre;21053;10965;10088
05554;      Borken, Kreis;30 bis unter 35 Jahre;20695;10743;9952
05554;      Borken, Kreis;35 bis unter 40 Jahre;22039;11256;10783
05554;      Borken, Kreis;40 bis unter 45 Jahre;30254;15665;14589
05554;      Borken, Kreis;45 bis unter 50 Jahre;33129;16971;16158
05554;      Borken, Kreis;50 bis unter 55 Jahre;28587;14564;14023
05554;      Borken, Kreis;55 bis unter 60 Jahre;23361;11770;11591
05554;      Borken, Kreis;60 bis unter 65 Jahre;19229;9822;9407
05554;      Borken, Kreis;65 bis unter 75 Jahre;33844;16192;17652
05554;      Borken, Kreis;75 Jahre und mehr;29957;11526;18431
05554;      Borken, Kreis;Insgesamt;369107;184795;184312
05558;      Coesfeld, Kreis;unter 3 Jahre;5064;2573;2491
05558;      Coesfeld, Kreis;3 bis unter 6 Jahre;5750;2947;2803
05558;      Coesfeld, Kreis;6 bis unter 10 Jahre;8534;4338;4196
05558;      Coesfeld, Kreis;10 bis unter 15 Jahre;13291;6783;6508
05558;      Coesfeld, Kreis;15 bis unter 18 Jahre;8661;4390;4271
05558;      Coesfeld, Kreis;18 bis unter 20 Jahre;5823;3007;2816
05558;      Coesfeld, Kreis;20 bis unter 25 Jahre;12621;6752;5869
05558;      Coesfeld, Kreis;25 bis unter 30 Jahre;11105;5748;5357
05558;      Coesfeld, Kreis;30 bis unter 35 Jahre;11163;5561;5602
05558;      Coesfeld, Kreis;35 bis unter 40 Jahre;12628;6305;6323
05558;      Coesfeld, Kreis;40 bis unter 45 Jahre;17766;8870;8896
05558;      Coesfeld, Kreis;45 bis unter 50 Jahre;20041;10018;10023
05558;      Coesfeld, Kreis;50 bis unter 55 Jahre;18223;9012;9211
05558;      Coesfeld, Kreis;55 bis unter 60 Jahre;15413;7758;7655
05558;      Coesfeld, Kreis;60 bis unter 65 Jahre;12633;6338;6295
05558;      Coesfeld, Kreis;65 bis unter 75 Jahre;21264;10118;11146
05558;      Coesfeld, Kreis;75 Jahre und mehr;18890;7079;11811
05558;      Coesfeld, Kreis;Insgesamt;218870;107597;111273
05562;      Recklinghausen, Kreis;unter 3 Jahre;13889;7096;6793
05562;      Recklinghausen, Kreis;3 bis unter 6 Jahre;14731;7493;7238
05562;      Recklinghausen, Kreis;6 bis unter 10 Jahre;21322;11063;10259
05562;      Recklinghausen, Kreis;10 bis unter 15 Jahre;31419;16209;15210
05562;      Recklinghausen, Kreis;15 bis unter 18 Jahre;20107;10340;9767
05562;      Recklinghausen, Kreis;18 bis unter 20 Jahre;14818;7628;7190
05562;      Recklinghausen, Kreis;20 bis unter 25 Jahre;36322;18872;17450
05562;      Recklinghausen, Kreis;25 bis unter 30 Jahre;32876;16970;15906
05562;      Recklinghausen, Kreis;30 bis unter 35 Jahre;33230;16516;16714
05562;      Recklinghausen, Kreis;35 bis unter 40 Jahre;35234;17373;17861
05562;      Recklinghausen, Kreis;40 bis unter 45 Jahre;48712;24215;24497
05562;      Recklinghausen, Kreis;45 bis unter 50 Jahre;52736;26435;26301
05562;      Recklinghausen, Kreis;50 bis unter 55 Jahre;50952;24987;25965
05562;      Recklinghausen, Kreis;55 bis unter 60 Jahre;46160;22607;23553
05562;      Recklinghausen, Kreis;60 bis unter 65 Jahre;40025;19606;20419
05562;      Recklinghausen, Kreis;65 bis unter 75 Jahre;68493;32174;36319
05562;      Recklinghausen, Kreis;75 Jahre und mehr;64497;24423;40074
05562;      Recklinghausen, Kreis;Insgesamt;625523;304007;321516
05566;      Steinfurt, Kreis;unter 3 Jahre;11187;5740;5447
05566;      Steinfurt, Kreis;3 bis unter 6 Jahre;12264;6356;5908
05566;      Steinfurt, Kreis;6 bis unter 10 Jahre;17933;9176;8757
05566;      Steinfurt, Kreis;10 bis unter 15 Jahre;26910;13876;13034
05566;      Steinfurt, Kreis;15 bis unter 18 Jahre;17015;8888;8127
05566;      Steinfurt, Kreis;18 bis unter 20 Jahre;11765;6199;5566
05566;      Steinfurt, Kreis;20 bis unter 25 Jahre;26529;14006;12523
05566;      Steinfurt, Kreis;25 bis unter 30 Jahre;23447;12189;11258
05566;      Steinfurt, Kreis;30 bis unter 35 Jahre;23129;11699;11430
05566;      Steinfurt, Kreis;35 bis unter 40 Jahre;25580;12695;12885
05566;      Steinfurt, Kreis;40 bis unter 45 Jahre;36514;18472;18042
05566;      Steinfurt, Kreis;45 bis unter 50 Jahre;40682;21067;19615
05566;      Steinfurt, Kreis;50 bis unter 55 Jahre;34804;17605;17199
05566;      Steinfurt, Kreis;55 bis unter 60 Jahre;28423;14229;14194
05566;      Steinfurt, Kreis;60 bis unter 65 Jahre;23976;11934;12042
05566;      Steinfurt, Kreis;65 bis unter 75 Jahre;43332;20644;22688
05566;      Steinfurt, Kreis;75 Jahre und mehr;38808;14674;24134
05566;      Steinfurt, Kreis;Insgesamt;442298;219449;222849
05570;      Warendorf, Kreis;unter 3 Jahre;6831;3544;3287
05570;      Warendorf, Kreis;3 bis unter 6 Jahre;7510;3856;3654
05570;      Warendorf, Kreis;6 bis unter 10 Jahre;11340;5800;5540
05570;      Warendorf, Kreis;10 bis unter 15 Jahre;16433;8323;8110
05570;      Warendorf, Kreis;15 bis unter 18 Jahre;10102;5106;4996
05570;      Warendorf, Kreis;18 bis unter 20 Jahre;7013;3571;3442
05570;      Warendorf, Kreis;20 bis unter 25 Jahre;16045;8479;7566
05570;      Warendorf, Kreis;25 bis unter 30 Jahre;14485;7656;6829
05570;      Warendorf, Kreis;30 bis unter 35 Jahre;14722;7382;7340
05570;      Warendorf, Kreis;35 bis unter 40 Jahre;16165;8115;8050
05570;      Warendorf, Kreis;40 bis unter 45 Jahre;22342;11473;10869
05570;      Warendorf, Kreis;45 bis unter 50 Jahre;23945;12174;11771
05570;      Warendorf, Kreis;50 bis unter 55 Jahre;21525;10861;10664
05570;      Warendorf, Kreis;55 bis unter 60 Jahre;18602;9137;9465
05570;      Warendorf, Kreis;60 bis unter 65 Jahre;16117;8009;8108
05570;      Warendorf, Kreis;65 bis unter 75 Jahre;28070;13357;14713
05570;      Warendorf, Kreis;75 Jahre und mehr;25802;9702;16100
05570;      Warendorf, Kreis;Insgesamt;277049;136545;140504
057;    Detmold, Regierungsbezirk;unter 3 Jahre;52791;27122;25669
057;    Detmold, Regierungsbezirk;3 bis unter 6 Jahre;55459;28393;27066
057;    Detmold, Regierungsbezirk;6 bis unter 10 Jahre;78853;40645;38208
057;    Detmold, Regierungsbezirk;10 bis unter 15 Jahre;112820;57720;55100
057;    Detmold, Regierungsbezirk;15 bis unter 18 Jahre;71328;36377;34951
057;    Detmold, Regierungsbezirk;18 bis unter 20 Jahre;49818;25452;24366
057;    Detmold, Regierungsbezirk;20 bis unter 25 Jahre;126805;65778;61027
057;    Detmold, Regierungsbezirk;25 bis unter 30 Jahre;119076;61058;58018
057;    Detmold, Regierungsbezirk;30 bis unter 35 Jahre;114674;57969;56705
057;    Detmold, Regierungsbezirk;35 bis unter 40 Jahre;117284;58065;59219
057;    Detmold, Regierungsbezirk;40 bis unter 45 Jahre;155691;78375;77316
057;    Detmold, Regierungsbezirk;45 bis unter 50 Jahre;170833;86440;84393
057;    Detmold, Regierungsbezirk;50 bis unter 55 Jahre;156393;78378;78015
057;    Detmold, Regierungsbezirk;55 bis unter 60 Jahre;131945;65254;66691
057;    Detmold, Regierungsbezirk;60 bis unter 65 Jahre;112316;55204;57112
057;    Detmold, Regierungsbezirk;65 bis unter 75 Jahre;207548;97545;110003
057;    Detmold, Regierungsbezirk;75 Jahre und mehr;200529;75507;125022
057;    Detmold, Regierungsbezirk;Insgesamt;2034163;995282;1038881
05711;      Bielefeld, Kreisfreie Stadt;unter 3 Jahre;8887;4589;4298
05711;      Bielefeld, Kreisfreie Stadt;3 bis unter 6 Jahre;8882;4590;4292
05711;      Bielefeld, Kreisfreie Stadt;6 bis unter 10 Jahre;11924;6207;5717
05711;      Bielefeld, Kreisfreie Stadt;10 bis unter 15 Jahre;16040;8123;7917
05711;      Bielefeld, Kreisfreie Stadt;15 bis unter 18 Jahre;9634;4861;4773
05711;      Bielefeld, Kreisfreie Stadt;18 bis unter 20 Jahre;7107;3563;3544
05711;      Bielefeld, Kreisfreie Stadt;20 bis unter 25 Jahre;22348;10591;11757
05711;      Bielefeld, Kreisfreie Stadt;25 bis unter 30 Jahre;23206;11328;11878
05711;      Bielefeld, Kreisfreie Stadt;30 bis unter 35 Jahre;20859;10409;10450
05711;      Bielefeld, Kreisfreie Stadt;35 bis unter 40 Jahre;19829;9849;9980
05711;      Bielefeld, Kreisfreie Stadt;40 bis unter 45 Jahre;23446;11841;11605
05711;      Bielefeld, Kreisfreie Stadt;45 bis unter 50 Jahre;26163;13102;13061
05711;      Bielefeld, Kreisfreie Stadt;50 bis unter 55 Jahre;22599;10976;11623
05711;      Bielefeld, Kreisfreie Stadt;55 bis unter 60 Jahre;19458;9282;10176
05711;      Bielefeld, Kreisfreie Stadt;60 bis unter 65 Jahre;16951;8024;8927
05711;      Bielefeld, Kreisfreie Stadt;65 bis unter 75 Jahre;33167;15292;17875
05711;      Bielefeld, Kreisfreie Stadt;75 Jahre und mehr;32895;12295;20600
05711;      Bielefeld, Kreisfreie Stadt;Insgesamt;323395;154922;168473
05754;      Gütersloh, Kreis;unter 3 Jahre;9356;4777;4579
05754;      Gütersloh, Kreis;3 bis unter 6 Jahre;9967;5165;4802
05754;      Gütersloh, Kreis;6 bis unter 10 Jahre;14522;7486;7036
05754;      Gütersloh, Kreis;10 bis unter 15 Jahre;20897;10694;10203
05754;      Gütersloh, Kreis;15 bis unter 18 Jahre;13066;6705;6361
05754;      Gütersloh, Kreis;18 bis unter 20 Jahre;8846;4556;4290
05754;      Gütersloh, Kreis;20 bis unter 25 Jahre;21335;11476;9859
05754;      Gütersloh, Kreis;25 bis unter 30 Jahre;20141;10533;9608
05754;      Gütersloh, Kreis;30 bis unter 35 Jahre;20157;10356;9801
05754;      Gütersloh, Kreis;35 bis unter 40 Jahre;21322;10564;10758
05754;      Gütersloh, Kreis;40 bis unter 45 Jahre;28599;14531;14068
05754;      Gütersloh, Kreis;45 bis unter 50 Jahre;31180;15813;15367
05754;      Gütersloh, Kreis;50 bis unter 55 Jahre;27523;13888;13635
05754;      Gütersloh, Kreis;55 bis unter 60 Jahre;22615;11234;11381
05754;      Gütersloh, Kreis;60 bis unter 65 Jahre;18812;9340;9472
05754;      Gütersloh, Kreis;65 bis unter 75 Jahre;35079;16628;18451
05754;      Gütersloh, Kreis;75 Jahre und mehr;31205;12030;19175
05754;      Gütersloh, Kreis;Insgesamt;354622;175776;178846
05758;      Herford, Kreis;unter 3 Jahre;6177;3234;2943
05758;      Herford, Kreis;3 bis unter 6 Jahre;6517;3318;3199
05758;      Herford, Kreis;6 bis unter 10 Jahre;9257;4667;4590
05758;      Herford, Kreis;10 bis unter 15 Jahre;13613;7037;6576
05758;      Herford, Kreis;15 bis unter 18 Jahre;8596;4395;4201
05758;      Herford, Kreis;18 bis unter 20 Jahre;6015;3133;2882
05758;      Herford, Kreis;20 bis unter 25 Jahre;14109;7383;6726
05758;      Herford, Kreis;25 bis unter 30 Jahre;13002;6549;6453
05758;      Herford, Kreis;30 bis unter 35 Jahre;13050;6585;6465
05758;      Herford, Kreis;35 bis unter 40 Jahre;13954;6751;7203
05758;      Herford, Kreis;40 bis unter 45 Jahre;19098;9529;9569
05758;      Herford, Kreis;45 bis unter 50 Jahre;21006;10593;10413
05758;      Herford, Kreis;50 bis unter 55 Jahre;19372;9612;9760
05758;      Herford, Kreis;55 bis unter 60 Jahre;16412;8094;8318
05758;      Herford, Kreis;60 bis unter 65 Jahre;14183;6950;7233
05758;      Herford, Kreis;65 bis unter 75 Jahre;26645;12512;14133
05758;      Herford, Kreis;75 Jahre und mehr;26748;9930;16818
05758;      Herford, Kreis;Insgesamt;247754;120272;127482
05762;      Höxter, Kreis;unter 3 Jahre;3371;1756;1615
05762;      Höxter, Kreis;3 bis unter 6 Jahre;3648;1851;1797
05762;      Höxter, Kreis;6 bis unter 10 Jahre;5558;2834;2724
05762;      Höxter, Kreis;10 bis unter 15 Jahre;8338;4211;4127
05762;      Höxter, Kreis;15 bis unter 18 Jahre;5424;2848;2576
05762;      Höxter, Kreis;18 bis unter 20 Jahre;3710;1914;1796
05762;      Höxter, Kreis;20 bis unter 25 Jahre;8521;4667;3854
05762;      Höxter, Kreis;25 bis unter 30 Jahre;7395;3929;3466
05762;      Höxter, Kreis;30 bis unter 35 Jahre;7350;3807;3543
05762;      Höxter, Kreis;35 bis unter 40 Jahre;7875;3957;3918
05762;      Höxter, Kreis;40 bis unter 45 Jahre;11187;5611;5576
05762;      Höxter, Kreis;45 bis unter 50 Jahre;12364;6347;6017
05762;      Höxter, Kreis;50 bis unter 55 Jahre;11769;6040;5729
05762;      Höxter, Kreis;55 bis unter 60 Jahre;10219;5230;4989
05762;      Höxter, Kreis;60 bis unter 65 Jahre;8623;4394;4229
05762;      Höxter, Kreis;65 bis unter 75 Jahre;15449;7454;7995
05762;      Höxter, Kreis;75 Jahre und mehr;15090;5595;9495
05762;      Höxter, Kreis;Insgesamt;145891;72445;73446
05766;      Lippe, Kreis;unter 3 Jahre;8839;4488;4351
05766;      Lippe, Kreis;3 bis unter 6 Jahre;9660;4904;4756
05766;      Lippe, Kreis;6 bis unter 10 Jahre;13572;7045;6527
05766;      Lippe, Kreis;10 bis unter 15 Jahre;19554;9988;9566
05766;      Lippe, Kreis;15 bis unter 18 Jahre;12606;6345;6261
05766;      Lippe, Kreis;18 bis unter 20 Jahre;8770;4462;4308
05766;      Lippe, Kreis;20 bis unter 25 Jahre;21020;11068;9952
05766;      Lippe, Kreis;25 bis unter 30 Jahre;18563;9642;8921
05766;      Lippe, Kreis;30 bis unter 35 Jahre;18059;8942;9117
05766;      Lippe, Kreis;35 bis unter 40 Jahre;18269;8851;9418
05766;      Lippe, Kreis;40 bis unter 45 Jahre;25914;12864;13050
05766;      Lippe, Kreis;45 bis unter 50 Jahre;28648;14360;14288
05766;      Lippe, Kreis;50 bis unter 55 Jahre;26898;13559;13339
05766;      Lippe, Kreis;55 bis unter 60 Jahre;23069;11366;11703
05766;      Lippe, Kreis;60 bis unter 65 Jahre;20463;9949;10514
05766;      Lippe, Kreis;65 bis unter 75 Jahre;37698;17610;20088
05766;      Lippe, Kreis;75 Jahre und mehr;37599;14361;23238
05766;      Lippe, Kreis;Insgesamt;349201;169804;179397
05770;      Minden-Lübbecke, Kreis;unter 3 Jahre;7838;4034;3804
05770;      Minden-Lübbecke, Kreis;3 bis unter 6 Jahre;8370;4249;4121
05770;      Minden-Lübbecke, Kreis;6 bis unter 10 Jahre;12072;6273;5799
05770;      Minden-Lübbecke, Kreis;10 bis unter 15 Jahre;17517;8950;8567
05770;      Minden-Lübbecke, Kreis;15 bis unter 18 Jahre;11254;5696;5558
05770;      Minden-Lübbecke, Kreis;18 bis unter 20 Jahre;7761;3979;3782
05770;      Minden-Lübbecke, Kreis;20 bis unter 25 Jahre;18102;9647;8455
05770;      Minden-Lübbecke, Kreis;25 bis unter 30 Jahre;16588;8660;7928
05770;      Minden-Lübbecke, Kreis;30 bis unter 35 Jahre;16247;8252;7995
05770;      Minden-Lübbecke, Kreis;35 bis unter 40 Jahre;17145;8580;8565
05770;      Minden-Lübbecke, Kreis;40 bis unter 45 Jahre;24055;12057;11998
05770;      Minden-Lübbecke, Kreis;45 bis unter 50 Jahre;25899;13134;12765
05770;      Minden-Lübbecke, Kreis;50 bis unter 55 Jahre;24755;12385;12370
05770;      Minden-Lübbecke, Kreis;55 bis unter 60 Jahre;20559;10178;10381
05770;      Minden-Lübbecke, Kreis;60 bis unter 65 Jahre;17843;8866;8977
05770;      Minden-Lübbecke, Kreis;65 bis unter 75 Jahre;33071;15558;17513
05770;      Minden-Lübbecke, Kreis;75 Jahre und mehr;33132;12399;20733
05770;      Minden-Lübbecke, Kreis;Insgesamt;312208;152897;159311
05774;      Paderborn, Kreis;unter 3 Jahre;8323;4244;4079
05774;      Paderborn, Kreis;3 bis unter 6 Jahre;8415;4316;4099
05774;      Paderborn, Kreis;6 bis unter 10 Jahre;11948;6133;5815
05774;      Paderborn, Kreis;10 bis unter 15 Jahre;16861;8717;8144
05774;      Paderborn, Kreis;15 bis unter 18 Jahre;10748;5527;5221
05774;      Paderborn, Kreis;18 bis unter 20 Jahre;7609;3845;3764
05774;      Paderborn, Kreis;20 bis unter 25 Jahre;21370;10946;10424
05774;      Paderborn, Kreis;25 bis unter 30 Jahre;20181;10417;9764
05774;      Paderborn, Kreis;30 bis unter 35 Jahre;18952;9618;9334
05774;      Paderborn, Kreis;35 bis unter 40 Jahre;18890;9513;9377
05774;      Paderborn, Kreis;40 bis unter 45 Jahre;23392;11942;11450
05774;      Paderborn, Kreis;45 bis unter 50 Jahre;25573;13091;12482
05774;      Paderborn, Kreis;50 bis unter 55 Jahre;23477;11918;11559
05774;      Paderborn, Kreis;55 bis unter 60 Jahre;19613;9870;9743
05774;      Paderborn, Kreis;60 bis unter 65 Jahre;15441;7681;7760
05774;      Paderborn, Kreis;65 bis unter 75 Jahre;26439;12491;13948
05774;      Paderborn, Kreis;75 Jahre und mehr;23860;8897;14963
05774;      Paderborn, Kreis;Insgesamt;301092;149166;151926
059;    Arnsberg, Regierungsbezirk;unter 3 Jahre;83906;42951;40955
059;    Arnsberg, Regierungsbezirk;3 bis unter 6 Jahre;88636;45618;43018
059;    Arnsberg, Regierungsbezirk;6 bis unter 10 Jahre;126744;65028;61716
059;    Arnsberg, Regierungsbezirk;10 bis unter 15 Jahre;183111;94370;88741
059;    Arnsberg, Regierungsbezirk;15 bis unter 18 Jahre;117256;60249;57007
059;    Arnsberg, Regierungsbezirk;18 bis unter 20 Jahre;84718;43288;41430
059;    Arnsberg, Regierungsbezirk;20 bis unter 25 Jahre;223739;115240;108499
059;    Arnsberg, Regierungsbezirk;25 bis unter 30 Jahre;211180;108904;102276
059;    Arnsberg, Regierungsbezirk;30 bis unter 35 Jahre;203577;103525;100052
059;    Arnsberg, Regierungsbezirk;35 bis unter 40 Jahre;206791;104227;102564
059;    Arnsberg, Regierungsbezirk;40 bis unter 45 Jahre;281854;143998;137856
059;    Arnsberg, Regierungsbezirk;45 bis unter 50 Jahre;313268;160809;152459
059;    Arnsberg, Regierungsbezirk;50 bis unter 55 Jahre;286393;144742;141651
059;    Arnsberg, Regierungsbezirk;55 bis unter 60 Jahre;251266;124690;126576
059;    Arnsberg, Regierungsbezirk;60 bis unter 65 Jahre;218625;107767;110858
059;    Arnsberg, Regierungsbezirk;65 bis unter 75 Jahre;399142;186705;212437
059;    Arnsberg, Regierungsbezirk;75 Jahre und mehr;365231;138102;227129
059;    Arnsberg, Regierungsbezirk;Insgesamt;3645437;1790213;1855224
05911;      Bochum, Kreisfreie Stadt;unter 3 Jahre;8022;4152;3870
05911;      Bochum, Kreisfreie Stadt;3 bis unter 6 Jahre;8144;4216;3928
05911;      Bochum, Kreisfreie Stadt;6 bis unter 10 Jahre;11109;5678;5431
05911;      Bochum, Kreisfreie Stadt;10 bis unter 15 Jahre;15588;8026;7562
05911;      Bochum, Kreisfreie Stadt;15 bis unter 18 Jahre;9718;4981;4737
05911;      Bochum, Kreisfreie Stadt;18 bis unter 20 Jahre;7405;3766;3639
05911;      Bochum, Kreisfreie Stadt;20 bis unter 25 Jahre;25255;12433;12822
05911;      Bochum, Kreisfreie Stadt;25 bis unter 30 Jahre;25574;12974;12600
05911;      Bochum, Kreisfreie Stadt;30 bis unter 35 Jahre;22347;11386;10961
05911;      Bochum, Kreisfreie Stadt;35 bis unter 40 Jahre;21517;10940;10577
05911;      Bochum, Kreisfreie Stadt;40 bis unter 45 Jahre;28909;14788;14121
05911;      Bochum, Kreisfreie Stadt;45 bis unter 50 Jahre;32608;16969;15639
05911;      Bochum, Kreisfreie Stadt;50 bis unter 55 Jahre;29607;15111;14496
05911;      Bochum, Kreisfreie Stadt;55 bis unter 60 Jahre;26147;13174;12973
05911;      Bochum, Kreisfreie Stadt;60 bis unter 65 Jahre;22807;11117;11690
05911;      Bochum, Kreisfreie Stadt;65 bis unter 75 Jahre;40416;18703;21713
05911;      Bochum, Kreisfreie Stadt;75 Jahre und mehr;38803;14171;24632
05911;      Bochum, Kreisfreie Stadt;Insgesamt;373976;182585;191391
05913;      Dortmund, Kreisfreie Stadt;unter 3 Jahre;14123;7146;6977
05913;      Dortmund, Kreisfreie Stadt;3 bis unter 6 Jahre;14318;7267;7051
05913;      Dortmund, Kreisfreie Stadt;6 bis unter 10 Jahre;19592;10121;9471
05913;      Dortmund, Kreisfreie Stadt;10 bis unter 15 Jahre;26768;13774;12994
05913;      Dortmund, Kreisfreie Stadt;15 bis unter 18 Jahre;17174;8804;8370
05913;      Dortmund, Kreisfreie Stadt;18 bis unter 20 Jahre;12548;6409;6139
05913;      Dortmund, Kreisfreie Stadt;20 bis unter 25 Jahre;38542;19409;19133
05913;      Dortmund, Kreisfreie Stadt;25 bis unter 30 Jahre;38638;19636;19002
05913;      Dortmund, Kreisfreie Stadt;30 bis unter 35 Jahre;36435;18618;17817
05913;      Dortmund, Kreisfreie Stadt;35 bis unter 40 Jahre;34069;17393;16676
05913;      Dortmund, Kreisfreie Stadt;40 bis unter 45 Jahre;43031;22559;20472
05913;      Dortmund, Kreisfreie Stadt;45 bis unter 50 Jahre;47741;24711;23030
05913;      Dortmund, Kreisfreie Stadt;50 bis unter 55 Jahre;43591;22178;21413
05913;      Dortmund, Kreisfreie Stadt;55 bis unter 60 Jahre;39212;19531;19681
05913;      Dortmund, Kreisfreie Stadt;60 bis unter 65 Jahre;34210;16736;17474
05913;      Dortmund, Kreisfreie Stadt;65 bis unter 75 Jahre;62948;29267;33681
05913;      Dortmund, Kreisfreie Stadt;75 Jahre und mehr;58016;21885;36131
05913;      Dortmund, Kreisfreie Stadt;Insgesamt;580956;285444;295512
05914;      Hagen, Kreisfreie Stadt;unter 3 Jahre;4394;2230;2164
05914;      Hagen, Kreisfreie Stadt;3 bis unter 6 Jahre;4592;2362;2230
05914;      Hagen, Kreisfreie Stadt;6 bis unter 10 Jahre;6731;3488;3243
05914;      Hagen, Kreisfreie Stadt;10 bis unter 15 Jahre;9467;4788;4679
05914;      Hagen, Kreisfreie Stadt;15 bis unter 18 Jahre;6057;3046;3011
05914;      Hagen, Kreisfreie Stadt;18 bis unter 20 Jahre;4542;2275;2267
05914;      Hagen, Kreisfreie Stadt;20 bis unter 25 Jahre;11576;5852;5724
05914;      Hagen, Kreisfreie Stadt;25 bis unter 30 Jahre;10524;5352;5172
05914;      Hagen, Kreisfreie Stadt;30 bis unter 35 Jahre;10199;5213;4986
05914;      Hagen, Kreisfreie Stadt;35 bis unter 40 Jahre;10323;5107;5216
05914;      Hagen, Kreisfreie Stadt;40 bis unter 45 Jahre;13771;6991;6780
05914;      Hagen, Kreisfreie Stadt;45 bis unter 50 Jahre;15124;7687;7437
05914;      Hagen, Kreisfreie Stadt;50 bis unter 55 Jahre;14206;7012;7194
05914;      Hagen, Kreisfreie Stadt;55 bis unter 60 Jahre;12643;6228;6415
05914;      Hagen, Kreisfreie Stadt;60 bis unter 65 Jahre;11140;5338;5802
05914;      Hagen, Kreisfreie Stadt;65 bis unter 75 Jahre;21804;9997;11807
05914;      Hagen, Kreisfreie Stadt;75 Jahre und mehr;20354;7490;12864
05914;      Hagen, Kreisfreie Stadt;Insgesamt;187447;90456;96991
05915;      Hamm, Kreisfreie Stadt;unter 3 Jahre;4442;2280;2162
05915;      Hamm, Kreisfreie Stadt;3 bis unter 6 Jahre;4727;2454;2273
05915;      Hamm, Kreisfreie Stadt;6 bis unter 10 Jahre;6634;3333;3301
05915;      Hamm, Kreisfreie Stadt;10 bis unter 15 Jahre;10033;5192;4841
05915;      Hamm, Kreisfreie Stadt;15 bis unter 18 Jahre;6266;3234;3032
05915;      Hamm, Kreisfreie Stadt;18 bis unter 20 Jahre;4484;2317;2167
05915;      Hamm, Kreisfreie Stadt;20 bis unter 25 Jahre;11151;5821;5330
05915;      Hamm, Kreisfreie Stadt;25 bis unter 30 Jahre;10439;5395;5044
05915;      Hamm, Kreisfreie Stadt;30 bis unter 35 Jahre;10987;5829;5158
05915;      Hamm, Kreisfreie Stadt;35 bis unter 40 Jahre;11646;6285;5361
05915;      Hamm, Kreisfreie Stadt;40 bis unter 45 Jahre;14224;7491;6733
05915;      Hamm, Kreisfreie Stadt;45 bis unter 50 Jahre;14919;7727;7192
05915;      Hamm, Kreisfreie Stadt;50 bis unter 55 Jahre;13595;6917;6678
05915;      Hamm, Kreisfreie Stadt;55 bis unter 60 Jahre;12096;5893;6203
05915;      Hamm, Kreisfreie Stadt;60 bis unter 65 Jahre;10828;5339;5489
05915;      Hamm, Kreisfreie Stadt;65 bis unter 75 Jahre;18545;8819;9726
05915;      Hamm, Kreisfreie Stadt;75 Jahre und mehr;17096;6491;10605
05915;      Hamm, Kreisfreie Stadt;Insgesamt;182112;90817;91295
05916;      Herne, Kreisfreie Stadt;unter 3 Jahre;3624;1804;1820
05916;      Herne, Kreisfreie Stadt;3 bis unter 6 Jahre;3745;1961;1784
05916;      Herne, Kreisfreie Stadt;6 bis unter 10 Jahre;5328;2737;2591
05916;      Herne, Kreisfreie Stadt;10 bis unter 15 Jahre;7824;3976;3848
05916;      Herne, Kreisfreie Stadt;15 bis unter 18 Jahre;4901;2443;2458
05916;      Herne, Kreisfreie Stadt;18 bis unter 20 Jahre;3497;1742;1755
05916;      Herne, Kreisfreie Stadt;20 bis unter 25 Jahre;9638;4968;4670
05916;      Herne, Kreisfreie Stadt;25 bis unter 30 Jahre;9189;4701;4488
05916;      Herne, Kreisfreie Stadt;30 bis unter 35 Jahre;9222;4769;4453
05916;      Herne, Kreisfreie Stadt;35 bis unter 40 Jahre;10006;5238;4768
05916;      Herne, Kreisfreie Stadt;40 bis unter 45 Jahre;13105;6803;6302
05916;      Herne, Kreisfreie Stadt;45 bis unter 50 Jahre;13961;7420;6541
05916;      Herne, Kreisfreie Stadt;50 bis unter 55 Jahre;12985;6702;6283
05916;      Herne, Kreisfreie Stadt;55 bis unter 60 Jahre;11604;5780;5824
05916;      Herne, Kreisfreie Stadt;60 bis unter 65 Jahre;10131;5082;5049
05916;      Herne, Kreisfreie Stadt;65 bis unter 75 Jahre;17947;8440;9507
05916;      Herne, Kreisfreie Stadt;75 Jahre und mehr;17537;6337;11200
05916;      Herne, Kreisfreie Stadt;Insgesamt;164244;80903;83341
05954;      Ennepe-Ruhr-Kreis;unter 3 Jahre;7091;3604;3487
05954;      Ennepe-Ruhr-Kreis;3 bis unter 6 Jahre;7469;3763;3706
05954;      Ennepe-Ruhr-Kreis;6 bis unter 10 Jahre;10734;5558;5176
05954;      Ennepe-Ruhr-Kreis;10 bis unter 15 Jahre;15733;8187;7546
05954;      Ennepe-Ruhr-Kreis;15 bis unter 18 Jahre;10028;5145;4883
05954;      Ennepe-Ruhr-Kreis;18 bis unter 20 Jahre;7210;3698;3512
05954;      Ennepe-Ruhr-Kreis;20 bis unter 25 Jahre;18072;9264;8808
05954;      Ennepe-Ruhr-Kreis;25 bis unter 30 Jahre;17173;8795;8378
05954;      Ennepe-Ruhr-Kreis;30 bis unter 35 Jahre;16826;8312;8514
05954;      Ennepe-Ruhr-Kreis;35 bis unter 40 Jahre;17588;8532;9056
05954;      Ennepe-Ruhr-Kreis;40 bis unter 45 Jahre;26316;13074;13242
05954;      Ennepe-Ruhr-Kreis;45 bis unter 50 Jahre;29701;14803;14898
05954;      Ennepe-Ruhr-Kreis;50 bis unter 55 Jahre;26477;13128;13349
05954;      Ennepe-Ruhr-Kreis;55 bis unter 60 Jahre;23562;11368;12194
05954;      Ennepe-Ruhr-Kreis;60 bis unter 65 Jahre;21133;10281;10852
05954;      Ennepe-Ruhr-Kreis;65 bis unter 75 Jahre;39691;18333;21358
05954;      Ennepe-Ruhr-Kreis;75 Jahre und mehr;35066;13296;21770
05954;      Ennepe-Ruhr-Kreis;Insgesamt;329870;159141;170729
05958;      Hochsauerlandkreis;unter 3 Jahre;6064;3138;2926
05958;      Hochsauerlandkreis;3 bis unter 6 Jahre;6722;3482;3240
05958;      Hochsauerlandkreis;6 bis unter 10 Jahre;10215;5255;4960
05958;      Hochsauerlandkreis;10 bis unter 15 Jahre;14795;7651;7144
05958;      Hochsauerlandkreis;15 bis unter 18 Jahre;9730;5170;4560
05958;      Hochsauerlandkreis;18 bis unter 20 Jahre;6750;3520;3230
05958;      Hochsauerlandkreis;20 bis unter 25 Jahre;15173;8115;7058
05958;      Hochsauerlandkreis;25 bis unter 30 Jahre;13796;7278;6518
05958;      Hochsauerlandkreis;30 bis unter 35 Jahre;13543;6682;6861
05958;      Hochsauerlandkreis;35 bis unter 40 Jahre;14779;7339;7440
05958;      Hochsauerlandkreis;40 bis unter 45 Jahre;20742;10613;10129
05958;      Hochsauerlandkreis;45 bis unter 50 Jahre;22472;11501;10971
05958;      Hochsauerlandkreis;50 bis unter 55 Jahre;20774;10474;10300
05958;      Hochsauerlandkreis;55 bis unter 60 Jahre;18117;9085;9032
05958;      Hochsauerlandkreis;60 bis unter 65 Jahre;15386;7755;7631
05958;      Hochsauerlandkreis;65 bis unter 75 Jahre;28762;13478;15284
05958;      Hochsauerlandkreis;75 Jahre und mehr;27425;10644;16781
05958;      Hochsauerlandkreis;Insgesamt;265245;131180;134065
05962;      Märkischer Kreis;unter 3 Jahre;10092;5182;4910
05962;      Märkischer Kreis;3 bis unter 6 Jahre;10883;5631;5252
05962;      Märkischer Kreis;6 bis unter 10 Jahre;15718;8058;7660
05962;      Märkischer Kreis;10 bis unter 15 Jahre;22768;11668;11100
05962;      Märkischer Kreis;15 bis unter 18 Jahre;14755;7578;7177
05962;      Märkischer Kreis;18 bis unter 20 Jahre;10836;5564;5272
05962;      Märkischer Kreis;20 bis unter 25 Jahre;25680;13453;12227
05962;      Märkischer Kreis;25 bis unter 30 Jahre;23352;12200;11152
05962;      Märkischer Kreis;30 bis unter 35 Jahre;22127;11267;10860
05962;      Märkischer Kreis;35 bis unter 40 Jahre;23416;11712;11704
05962;      Märkischer Kreis;40 bis unter 45 Jahre;33048;16763;16285
05962;      Märkischer Kreis;45 bis unter 50 Jahre;37954;19488;18466
05962;      Märkischer Kreis;50 bis unter 55 Jahre;33944;17115;16829
05962;      Märkischer Kreis;55 bis unter 60 Jahre;28816;14284;14532
05962;      Märkischer Kreis;60 bis unter 65 Jahre;25434;12367;13067
05962;      Märkischer Kreis;65 bis unter 75 Jahre;48253;22567;25686
05962;      Märkischer Kreis;75 Jahre und mehr;41309;15872;25437
05962;      Märkischer Kreis;Insgesamt;428385;210769;217616
05966;      Olpe, Kreis;unter 3 Jahre;3346;1753;1593
05966;      Olpe, Kreis;3 bis unter 6 Jahre;3611;1906;1705
05966;      Olpe, Kreis;6 bis unter 10 Jahre;5345;2774;2571
05966;      Olpe, Kreis;10 bis unter 15 Jahre;8007;4153;3854
05966;      Olpe, Kreis;15 bis unter 18 Jahre;4998;2534;2464
05966;      Olpe, Kreis;18 bis unter 20 Jahre;3578;1823;1755
05966;      Olpe, Kreis;20 bis unter 25 Jahre;8380;4418;3962
05966;      Olpe, Kreis;25 bis unter 30 Jahre;7710;3979;3731
05966;      Olpe, Kreis;30 bis unter 35 Jahre;7883;3998;3885
05966;      Olpe, Kreis;35 bis unter 40 Jahre;8131;4077;4054
05966;      Olpe, Kreis;40 bis unter 45 Jahre;11458;5925;5533
05966;      Olpe, Kreis;45 bis unter 50 Jahre;12487;6566;5921
05966;      Olpe, Kreis;50 bis unter 55 Jahre;10953;5574;5379
05966;      Olpe, Kreis;55 bis unter 60 Jahre;9244;4750;4494
05966;      Olpe, Kreis;60 bis unter 65 Jahre;7426;3797;3629
05966;      Olpe, Kreis;65 bis unter 75 Jahre;13432;6416;7016
05966;      Olpe, Kreis;75 Jahre und mehr;12416;4689;7727
05966;      Olpe, Kreis;Insgesamt;138405;69132;69273
05970;      Siegen-Wittgenstein, Kreis;unter 3 Jahre;6632;3411;3221
05970;      Siegen-Wittgenstein, Kreis;3 bis unter 6 Jahre;6729;3452;3277
05970;      Siegen-Wittgenstein, Kreis;6 bis unter 10 Jahre;9570;4909;4661
05970;      Siegen-Wittgenstein, Kreis;10 bis unter 15 Jahre;14069;7165;6904
05970;      Siegen-Wittgenstein, Kreis;15 bis unter 18 Jahre;9258;4848;4410
05970;      Siegen-Wittgenstein, Kreis;18 bis unter 20 Jahre;6774;3460;3314
05970;      Siegen-Wittgenstein, Kreis;20 bis unter 25 Jahre;18815;9768;9047
05970;      Siegen-Wittgenstein, Kreis;25 bis unter 30 Jahre;17027;8923;8104
05970;      Siegen-Wittgenstein, Kreis;30 bis unter 35 Jahre;15661;8060;7601
05970;      Siegen-Wittgenstein, Kreis;35 bis unter 40 Jahre;15383;7822;7561
05970;      Siegen-Wittgenstein, Kreis;40 bis unter 45 Jahre;21066;10783;10283
05970;      Siegen-Wittgenstein, Kreis;45 bis unter 50 Jahre;24262;12618;11644
05970;      Siegen-Wittgenstein, Kreis;50 bis unter 55 Jahre;22266;11334;10932
05970;      Siegen-Wittgenstein, Kreis;55 bis unter 60 Jahre;19365;9655;9710
05970;      Siegen-Wittgenstein, Kreis;60 bis unter 65 Jahre;16966;8406;8560
05970;      Siegen-Wittgenstein, Kreis;65 bis unter 75 Jahre;30128;14189;15939
05970;      Siegen-Wittgenstein, Kreis;75 Jahre und mehr;27614;10636;16978
05970;      Siegen-Wittgenstein, Kreis;Insgesamt;281585;139439;142146
05974;      Soest, Kreis;unter 3 Jahre;7285;3693;3592
05974;      Soest, Kreis;3 bis unter 6 Jahre;7949;4063;3886
05974;      Soest, Kreis;6 bis unter 10 Jahre;11616;5870;5746
05974;      Soest, Kreis;10 bis unter 15 Jahre;16690;8611;8079
05974;      Soest, Kreis;15 bis unter 18 Jahre;10482;5310;5172
05974;      Soest, Kreis;18 bis unter 20 Jahre;7338;3697;3641
05974;      Soest, Kreis;20 bis unter 25 Jahre;17589;9304;8285
05974;      Soest, Kreis;25 bis unter 30 Jahre;16186;8458;7728
05974;      Soest, Kreis;30 bis unter 35 Jahre;16470;8268;8202
05974;      Soest, Kreis;35 bis unter 40 Jahre;17437;8706;8731
05974;      Soest, Kreis;40 bis unter 45 Jahre;24431;12318;12113
05974;      Soest, Kreis;45 bis unter 50 Jahre;26564;13441;13123
05974;      Soest, Kreis;50 bis unter 55 Jahre;24393;12368;12025
05974;      Soest, Kreis;55 bis unter 60 Jahre;20829;10478;10351
05974;      Soest, Kreis;60 bis unter 65 Jahre;17544;8825;8719
05974;      Soest, Kreis;65 bis unter 75 Jahre;32085;15143;16942
05974;      Soest, Kreis;75 Jahre und mehr;28800;10966;17834
05974;      Soest, Kreis;Insgesamt;303688;149519;154169
05978;      Unna, Kreis;unter 3 Jahre;8791;4558;4233
05978;      Unna, Kreis;3 bis unter 6 Jahre;9747;5061;4686
05978;      Unna, Kreis;6 bis unter 10 Jahre;14152;7247;6905
05978;      Unna, Kreis;10 bis unter 15 Jahre;21369;11179;10190
05978;      Unna, Kreis;15 bis unter 18 Jahre;13889;7156;6733
05978;      Unna, Kreis;18 bis unter 20 Jahre;9756;5017;4739
05978;      Unna, Kreis;20 bis unter 25 Jahre;23868;12435;11433
05978;      Unna, Kreis;25 bis unter 30 Jahre;21572;11213;10359
05978;      Unna, Kreis;30 bis unter 35 Jahre;21877;11123;10754
05978;      Unna, Kreis;35 bis unter 40 Jahre;22496;11076;11420
05978;      Unna, Kreis;40 bis unter 45 Jahre;31753;15890;15863
05978;      Unna, Kreis;45 bis unter 50 Jahre;35475;17878;17597
05978;      Unna, Kreis;50 bis unter 55 Jahre;33602;16829;16773
05978;      Unna, Kreis;55 bis unter 60 Jahre;29631;14464;15167
05978;      Unna, Kreis;60 bis unter 65 Jahre;25620;12724;12896
05978;      Unna, Kreis;65 bis unter 75 Jahre;45131;21353;23778
05978;      Unna, Kreis;75 Jahre und mehr;40795;15625;25170
05978;      Unna, Kreis;Insgesamt;409524;200828;208696
06;  Hessen;unter 3 Jahre;155182;79374;75808
06;  Hessen;3 bis unter 6 Jahre;157491;80770;76721
06;  Hessen;6 bis unter 10 Jahre;215976;110701;105275
06;  Hessen;10 bis unter 15 Jahre;296572;151992;144580
06;  Hessen;15 bis unter 18 Jahre;183893;94390;89503
06;  Hessen;18 bis unter 20 Jahre;129172;65845;63327
06;  Hessen;20 bis unter 25 Jahre;358349;181591;176758
06;  Hessen;25 bis unter 30 Jahre;364255;183097;181158
06;  Hessen;30 bis unter 35 Jahre;373509;185703;187806
06;  Hessen;35 bis unter 40 Jahre;372159;185763;186396
06;  Hessen;40 bis unter 45 Jahre;485828;246874;238954
06;  Hessen;45 bis unter 50 Jahre;536227;273427;262800
06;  Hessen;50 bis unter 55 Jahre;471861;238442;233419
06;  Hessen;55 bis unter 60 Jahre;401186;198921;202265
06;  Hessen;60 bis unter 65 Jahre;372052;182794;189258
06;  Hessen;65 bis unter 75 Jahre;648346;310174;338172
06;  Hessen;75 Jahre und mehr;570068;223906;346162
06;  Hessen;Insgesamt;6092126;2993764;3098362
064;    Darmstadt, Regierungsbezirk;unter 3 Jahre;102734;52479;50255
064;    Darmstadt, Regierungsbezirk;3 bis unter 6 Jahre;103141;52882;50259
064;    Darmstadt, Regierungsbezirk;6 bis unter 10 Jahre;138496;71078;67418
064;    Darmstadt, Regierungsbezirk;10 bis unter 15 Jahre;183847;94069;89778
064;    Darmstadt, Regierungsbezirk;15 bis unter 18 Jahre;111331;57368;53963
064;    Darmstadt, Regierungsbezirk;18 bis unter 20 Jahre;77300;39333;37967
064;    Darmstadt, Regierungsbezirk;20 bis unter 25 Jahre;215852;109879;105973
064;    Darmstadt, Regierungsbezirk;25 bis unter 30 Jahre;233013;115726;117287
064;    Darmstadt, Regierungsbezirk;30 bis unter 35 Jahre;249436;122979;126457
064;    Darmstadt, Regierungsbezirk;35 bis unter 40 Jahre;246002;123184;122818
064;    Darmstadt, Regierungsbezirk;40 bis unter 45 Jahre;313872;160149;153723
064;    Darmstadt, Regierungsbezirk;45 bis unter 50 Jahre;341060;174105;166955
064;    Darmstadt, Regierungsbezirk;50 bis unter 55 Jahre;292562;148137;144425
064;    Darmstadt, Regierungsbezirk;55 bis unter 60 Jahre;247177;121864;125313
064;    Darmstadt, Regierungsbezirk;60 bis unter 65 Jahre;232115;113172;118943
064;    Darmstadt, Regierungsbezirk;65 bis unter 75 Jahre;406546;194459;212087
064;    Darmstadt, Regierungsbezirk;75 Jahre und mehr;341108;135461;205647
064;    Darmstadt, Regierungsbezirk;Insgesamt;3835592;1886324;1949268
06411;      Darmstadt, Kreisfreie Stadt;unter 3 Jahre;4328;2234;2094
06411;      Darmstadt, Kreisfreie Stadt;3 bis unter 6 Jahre;4082;2098;1984
06411;      Darmstadt, Kreisfreie Stadt;6 bis unter 10 Jahre;5045;2573;2472
06411;      Darmstadt, Kreisfreie Stadt;10 bis unter 15 Jahre;6124;3106;3018
06411;      Darmstadt, Kreisfreie Stadt;15 bis unter 18 Jahre;3490;1739;1751
06411;      Darmstadt, Kreisfreie Stadt;18 bis unter 20 Jahre;2820;1470;1350
06411;      Darmstadt, Kreisfreie Stadt;20 bis unter 25 Jahre;12657;7118;5539
06411;      Darmstadt, Kreisfreie Stadt;25 bis unter 30 Jahre;13182;7268;5914
06411;      Darmstadt, Kreisfreie Stadt;30 bis unter 35 Jahre;11078;5815;5263
06411;      Darmstadt, Kreisfreie Stadt;35 bis unter 40 Jahre;9197;4606;4591
06411;      Darmstadt, Kreisfreie Stadt;40 bis unter 45 Jahre;10742;5680;5062
06411;      Darmstadt, Kreisfreie Stadt;45 bis unter 50 Jahre;12365;6475;5890
06411;      Darmstadt, Kreisfreie Stadt;50 bis unter 55 Jahre;11198;5920;5278
06411;      Darmstadt, Kreisfreie Stadt;55 bis unter 60 Jahre;8485;4238;4247
06411;      Darmstadt, Kreisfreie Stadt;60 bis unter 65 Jahre;7958;3806;4152
06411;      Darmstadt, Kreisfreie Stadt;65 bis unter 75 Jahre;13560;6348;7212
06411;      Darmstadt, Kreisfreie Stadt;75 Jahre und mehr;12741;4799;7942
06411;      Darmstadt, Kreisfreie Stadt;Insgesamt;149052;75293;73759
06412;      Frankfurt am Main, Kreisfreie Stadt;unter 3 Jahre;21558;10896;10662
06412;      Frankfurt am Main, Kreisfreie Stadt;3 bis unter 6 Jahre;19584;10034;9550
06412;      Frankfurt am Main, Kreisfreie Stadt;6 bis unter 10 Jahre;23436;11957;11479
06412;      Frankfurt am Main, Kreisfreie Stadt;10 bis unter 15 Jahre;27092;13866;13226
06412;      Frankfurt am Main, Kreisfreie Stadt;15 bis unter 18 Jahre;15553;8103;7450
06412;      Frankfurt am Main, Kreisfreie Stadt;18 bis unter 20 Jahre;11159;5643;5516
06412;      Frankfurt am Main, Kreisfreie Stadt;20 bis unter 25 Jahre;40132;19198;20934
06412;      Frankfurt am Main, Kreisfreie Stadt;25 bis unter 30 Jahre;56427;26960;29467
06412;      Frankfurt am Main, Kreisfreie Stadt;30 bis unter 35 Jahre;61077;30096;30981
06412;      Frankfurt am Main, Kreisfreie Stadt;35 bis unter 40 Jahre;53599;27840;25759
06412;      Frankfurt am Main, Kreisfreie Stadt;40 bis unter 45 Jahre;57285;30370;26915
06412;      Frankfurt am Main, Kreisfreie Stadt;45 bis unter 50 Jahre;59715;30555;29160
06412;      Frankfurt am Main, Kreisfreie Stadt;50 bis unter 55 Jahre;49094;25015;24079
06412;      Frankfurt am Main, Kreisfreie Stadt;55 bis unter 60 Jahre;41332;20194;21138
06412;      Frankfurt am Main, Kreisfreie Stadt;60 bis unter 65 Jahre;37394;18385;19009
06412;      Frankfurt am Main, Kreisfreie Stadt;65 bis unter 75 Jahre;62798;29968;32830
06412;      Frankfurt am Main, Kreisfreie Stadt;75 Jahre und mehr;54283;20461;33822
06412;      Frankfurt am Main, Kreisfreie Stadt;Insgesamt;691518;339541;351977
06413;      Offenbach am Main, Kreisfreie Stadt;unter 3 Jahre;3886;1993;1893
06413;      Offenbach am Main, Kreisfreie Stadt;3 bis unter 6 Jahre;3742;1901;1841
06413;      Offenbach am Main, Kreisfreie Stadt;6 bis unter 10 Jahre;4825;2487;2338
06413;      Offenbach am Main, Kreisfreie Stadt;10 bis unter 15 Jahre;5741;2963;2778
06413;      Offenbach am Main, Kreisfreie Stadt;15 bis unter 18 Jahre;3480;1775;1705
06413;      Offenbach am Main, Kreisfreie Stadt;18 bis unter 20 Jahre;2416;1196;1220
06413;      Offenbach am Main, Kreisfreie Stadt;20 bis unter 25 Jahre;8199;4045;4154
06413;      Offenbach am Main, Kreisfreie Stadt;25 bis unter 30 Jahre;9057;4504;4553
06413;      Offenbach am Main, Kreisfreie Stadt;30 bis unter 35 Jahre;9209;4780;4429
06413;      Offenbach am Main, Kreisfreie Stadt;35 bis unter 40 Jahre;8757;4659;4098
06413;      Offenbach am Main, Kreisfreie Stadt;40 bis unter 45 Jahre;9799;5366;4433
06413;      Offenbach am Main, Kreisfreie Stadt;45 bis unter 50 Jahre;9938;5314;4624
06413;      Offenbach am Main, Kreisfreie Stadt;50 bis unter 55 Jahre;8552;4452;4100
06413;      Offenbach am Main, Kreisfreie Stadt;55 bis unter 60 Jahre;7321;3703;3618
06413;      Offenbach am Main, Kreisfreie Stadt;60 bis unter 65 Jahre;6644;3258;3386
06413;      Offenbach am Main, Kreisfreie Stadt;65 bis unter 75 Jahre;11602;5647;5955
06413;      Offenbach am Main, Kreisfreie Stadt;75 Jahre und mehr;9537;3777;5760
06413;      Offenbach am Main, Kreisfreie Stadt;Insgesamt;122705;61820;60885
06414;      Wiesbaden, Landeshauptstadt, Kreisfreie Stadt;unter 3 Jahre;8257;4219;4038
06414;      Wiesbaden, Landeshauptstadt, Kreisfreie Stadt;3 bis unter 6 Jahre;7972;4055;3917
06414;      Wiesbaden, Landeshauptstadt, Kreisfreie Stadt;6 bis unter 10 Jahre;10144;5236;4908
06414;      Wiesbaden, Landeshauptstadt, Kreisfreie Stadt;10 bis unter 15 Jahre;12642;6451;6191
06414;      Wiesbaden, Landeshauptstadt, Kreisfreie Stadt;15 bis unter 18 Jahre;7418;3813;3605
06414;      Wiesbaden, Landeshauptstadt, Kreisfreie Stadt;18 bis unter 20 Jahre;5334;2653;2681
06414;      Wiesbaden, Landeshauptstadt, Kreisfreie Stadt;20 bis unter 25 Jahre;16448;7998;8450
06414;      Wiesbaden, Landeshauptstadt, Kreisfreie Stadt;25 bis unter 30 Jahre;18632;8678;9954
06414;      Wiesbaden, Landeshauptstadt, Kreisfreie Stadt;30 bis unter 35 Jahre;19801;9605;10196
06414;      Wiesbaden, Landeshauptstadt, Kreisfreie Stadt;35 bis unter 40 Jahre;18787;9405;9382
06414;      Wiesbaden, Landeshauptstadt, Kreisfreie Stadt;40 bis unter 45 Jahre;22934;11695;11239
06414;      Wiesbaden, Landeshauptstadt, Kreisfreie Stadt;45 bis unter 50 Jahre;23717;12015;11702
06414;      Wiesbaden, Landeshauptstadt, Kreisfreie Stadt;50 bis unter 55 Jahre;20192;10078;10114
06414;      Wiesbaden, Landeshauptstadt, Kreisfreie Stadt;55 bis unter 60 Jahre;16710;8024;8686
06414;      Wiesbaden, Landeshauptstadt, Kreisfreie Stadt;60 bis unter 65 Jahre;15743;7539;8204
06414;      Wiesbaden, Landeshauptstadt, Kreisfreie Stadt;65 bis unter 75 Jahre;28958;13349;15609
06414;      Wiesbaden, Landeshauptstadt, Kreisfreie Stadt;75 Jahre und mehr;25230;9753;15477
06414;      Wiesbaden, Landeshauptstadt, Kreisfreie Stadt;Insgesamt;278919;134566;144353
06431;      Bergstraße, Landkreis;unter 3 Jahre;6131;3171;2960
06431;      Bergstraße, Landkreis;3 bis unter 6 Jahre;6268;3266;3002
06431;      Bergstraße, Landkreis;6 bis unter 10 Jahre;9090;4725;4365
06431;      Bergstraße, Landkreis;10 bis unter 15 Jahre;13255;6782;6473
06431;      Bergstraße, Landkreis;15 bis unter 18 Jahre;8577;4382;4195
06431;      Bergstraße, Landkreis;18 bis unter 20 Jahre;5896;2998;2898
06431;      Bergstraße, Landkreis;20 bis unter 25 Jahre;14077;7294;6783
06431;      Bergstraße, Landkreis;25 bis unter 30 Jahre;13511;6873;6638
06431;      Bergstraße, Landkreis;30 bis unter 35 Jahre;14213;7126;7087
06431;      Bergstraße, Landkreis;35 bis unter 40 Jahre;14754;7293;7461
06431;      Bergstraße, Landkreis;40 bis unter 45 Jahre;21165;10598;10567
06431;      Bergstraße, Landkreis;45 bis unter 50 Jahre;24032;12120;11912
06431;      Bergstraße, Landkreis;50 bis unter 55 Jahre;21646;10856;10790
06431;      Bergstraße, Landkreis;55 bis unter 60 Jahre;18434;9100;9334
06431;      Bergstraße, Landkreis;60 bis unter 65 Jahre;17130;8394;8736
06431;      Bergstraße, Landkreis;65 bis unter 75 Jahre;29432;14049;15383
06431;      Bergstraße, Landkreis;75 Jahre und mehr;25191;10045;15146
06431;      Bergstraße, Landkreis;Insgesamt;262802;129072;133730
06432;      Darmstadt-Dieburg, Landkreis;unter 3 Jahre;7262;3707;3555
06432;      Darmstadt-Dieburg, Landkreis;3 bis unter 6 Jahre;7505;3871;3634
06432;      Darmstadt-Dieburg, Landkreis;6 bis unter 10 Jahre;10475;5332;5143
06432;      Darmstadt-Dieburg, Landkreis;10 bis unter 15 Jahre;15055;7764;7291
06432;      Darmstadt-Dieburg, Landkreis;15 bis unter 18 Jahre;9470;4887;4583
06432;      Darmstadt-Dieburg, Landkreis;18 bis unter 20 Jahre;6436;3299;3137
06432;      Darmstadt-Dieburg, Landkreis;20 bis unter 25 Jahre;16337;8558;7779
06432;      Darmstadt-Dieburg, Landkreis;25 bis unter 30 Jahre;15125;7681;7444
06432;      Darmstadt-Dieburg, Landkreis;30 bis unter 35 Jahre;16572;8105;8467
06432;      Darmstadt-Dieburg, Landkreis;35 bis unter 40 Jahre;17135;8423;8712
06432;      Darmstadt-Dieburg, Landkreis;40 bis unter 45 Jahre;23990;12114;11876
06432;      Darmstadt-Dieburg, Landkreis;45 bis unter 50 Jahre;27569;14227;13342
06432;      Darmstadt-Dieburg, Landkreis;50 bis unter 55 Jahre;23501;11978;11523
06432;      Darmstadt-Dieburg, Landkreis;55 bis unter 60 Jahre;19762;9830;9932
06432;      Darmstadt-Dieburg, Landkreis;60 bis unter 65 Jahre;18701;9267;9434
06432;      Darmstadt-Dieburg, Landkreis;65 bis unter 75 Jahre;30753;14933;15820
06432;      Darmstadt-Dieburg, Landkreis;75 Jahre und mehr;24384;9936;14448
06432;      Darmstadt-Dieburg, Landkreis;Insgesamt;290032;143912;146120
06433;      Groß-Gerau, Landkreis;unter 3 Jahre;7114;3619;3495
06433;      Groß-Gerau, Landkreis;3 bis unter 6 Jahre;6929;3479;3450
06433;      Groß-Gerau, Landkreis;6 bis unter 10 Jahre;9493;4890;4603
06433;      Groß-Gerau, Landkreis;10 bis unter 15 Jahre;13055;6653;6402
06433;      Groß-Gerau, Landkreis;15 bis unter 18 Jahre;7960;4065;3895
06433;      Groß-Gerau, Landkreis;18 bis unter 20 Jahre;5544;2789;2755
06433;      Groß-Gerau, Landkreis;20 bis unter 25 Jahre;15013;7745;7268
06433;      Groß-Gerau, Landkreis;25 bis unter 30 Jahre;15650;7927;7723
06433;      Groß-Gerau, Landkreis;30 bis unter 35 Jahre;16724;8389;8335
06433;      Groß-Gerau, Landkreis;35 bis unter 40 Jahre;16067;8151;7916
06433;      Groß-Gerau, Landkreis;40 bis unter 45 Jahre;20696;10653;10043
06433;      Groß-Gerau, Landkreis;45 bis unter 50 Jahre;22784;11892;10892
06433;      Groß-Gerau, Landkreis;50 bis unter 55 Jahre;19282;9934;9348
06433;      Groß-Gerau, Landkreis;55 bis unter 60 Jahre;16289;8129;8160
06433;      Groß-Gerau, Landkreis;60 bis unter 65 Jahre;15516;7638;7878
06433;      Groß-Gerau, Landkreis;65 bis unter 75 Jahre;27287;13248;14039
06433;      Groß-Gerau, Landkreis;75 Jahre und mehr;21740;8977;12763
06433;      Groß-Gerau, Landkreis;Insgesamt;257143;128178;128965
06434;      Hochtaunuskreis;unter 3 Jahre;6008;3068;2940
06434;      Hochtaunuskreis;3 bis unter 6 Jahre;6446;3288;3158
06434;      Hochtaunuskreis;6 bis unter 10 Jahre;9069;4672;4397
06434;      Hochtaunuskreis;10 bis unter 15 Jahre;11969;6148;5821
06434;      Hochtaunuskreis;15 bis unter 18 Jahre;7069;3624;3445
06434;      Hochtaunuskreis;18 bis unter 20 Jahre;4580;2350;2230
06434;      Hochtaunuskreis;20 bis unter 25 Jahre;10217;5119;5098
06434;      Hochtaunuskreis;25 bis unter 30 Jahre;10267;5079;5188
06434;      Hochtaunuskreis;30 bis unter 35 Jahre;11953;5609;6344
06434;      Hochtaunuskreis;35 bis unter 40 Jahre;13815;6557;7258
06434;      Hochtaunuskreis;40 bis unter 45 Jahre;19345;9462;9883
06434;      Hochtaunuskreis;45 bis unter 50 Jahre;21020;10378;10642
06434;      Hochtaunuskreis;50 bis unter 55 Jahre;17221;8529;8692
06434;      Hochtaunuskreis;55 bis unter 60 Jahre;14600;7152;7448
06434;      Hochtaunuskreis;60 bis unter 65 Jahre;14099;6710;7389
06434;      Hochtaunuskreis;65 bis unter 75 Jahre;27501;12998;14503
06434;      Hochtaunuskreis;75 Jahre und mehr;23153;9147;14006
06434;      Hochtaunuskreis;Insgesamt;228332;109890;118442
06435;      Main-Kinzig-Kreis;unter 3 Jahre;9722;4902;4820
06435;      Main-Kinzig-Kreis;3 bis unter 6 Jahre;10334;5302;5032
06435;      Main-Kinzig-Kreis;6 bis unter 10 Jahre;14447;7343;7104
06435;      Main-Kinzig-Kreis;10 bis unter 15 Jahre;20782;10757;10025
06435;      Main-Kinzig-Kreis;15 bis unter 18 Jahre;12661;6658;6003
06435;      Main-Kinzig-Kreis;18 bis unter 20 Jahre;9081;4666;4415
06435;      Main-Kinzig-Kreis;20 bis unter 25 Jahre;22984;11698;11286
06435;      Main-Kinzig-Kreis;25 bis unter 30 Jahre;21852;11002;10850
06435;      Main-Kinzig-Kreis;30 bis unter 35 Jahre;23311;11546;11765
06435;      Main-Kinzig-Kreis;35 bis unter 40 Jahre;24403;12072;12331
06435;      Main-Kinzig-Kreis;40 bis unter 45 Jahre;33199;16856;16343
06435;      Main-Kinzig-Kreis;45 bis unter 50 Jahre;35980;18375;17605
06435;      Main-Kinzig-Kreis;50 bis unter 55 Jahre;32353;16418;15935
06435;      Main-Kinzig-Kreis;55 bis unter 60 Jahre;27701;13709;13992
06435;      Main-Kinzig-Kreis;60 bis unter 65 Jahre;26339;12747;13592
06435;      Main-Kinzig-Kreis;65 bis unter 75 Jahre;45274;21896;23378
06435;      Main-Kinzig-Kreis;75 Jahre und mehr;37677;14921;22756
06435;      Main-Kinzig-Kreis;Insgesamt;408100;200868;207232
06436;      Main-Taunus-Kreis;unter 3 Jahre;6255;3228;3027
06436;      Main-Taunus-Kreis;3 bis unter 6 Jahre;6703;3467;3236
06436;      Main-Taunus-Kreis;6 bis unter 10 Jahre;9111;4668;4443
06436;      Main-Taunus-Kreis;10 bis unter 15 Jahre;11464;5893;5571
06436;      Main-Taunus-Kreis;15 bis unter 18 Jahre;6688;3432;3256
06436;      Main-Taunus-Kreis;18 bis unter 20 Jahre;4343;2198;2145
06436;      Main-Taunus-Kreis;20 bis unter 25 Jahre;10631;5426;5205
06436;      Main-Taunus-Kreis;25 bis unter 30 Jahre;11524;5661;5863
06436;      Main-Taunus-Kreis;30 bis unter 35 Jahre;13619;6547;7072
06436;      Main-Taunus-Kreis;35 bis unter 40 Jahre;14761;7188;7573
06436;      Main-Taunus-Kreis;40 bis unter 45 Jahre;19855;9717;10138
06436;      Main-Taunus-Kreis;45 bis unter 50 Jahre;20694;10384;10310
06436;      Main-Taunus-Kreis;50 bis unter 55 Jahre;17275;8511;8764
06436;      Main-Taunus-Kreis;55 bis unter 60 Jahre;14126;6884;7242
06436;      Main-Taunus-Kreis;60 bis unter 65 Jahre;13821;6596;7225
06436;      Main-Taunus-Kreis;65 bis unter 75 Jahre;26451;12457;13994
06436;      Main-Taunus-Kreis;75 Jahre und mehr;21150;8932;12218
06436;      Main-Taunus-Kreis;Insgesamt;228471;111189;117282
06437;      Odenwaldkreis;unter 3 Jahre;2139;1092;1047
06437;      Odenwaldkreis;3 bis unter 6 Jahre;2278;1147;1131
06437;      Odenwaldkreis;6 bis unter 10 Jahre;3353;1719;1634
06437;      Odenwaldkreis;10 bis unter 15 Jahre;4979;2531;2448
06437;      Odenwaldkreis;15 bis unter 18 Jahre;3249;1676;1573
06437;      Odenwaldkreis;18 bis unter 20 Jahre;2364;1219;1145
06437;      Odenwaldkreis;20 bis unter 25 Jahre;5700;3068;2632
06437;      Odenwaldkreis;25 bis unter 30 Jahre;4942;2598;2344
06437;      Odenwaldkreis;30 bis unter 35 Jahre;4992;2457;2535
06437;      Odenwaldkreis;35 bis unter 40 Jahre;5251;2633;2618
06437;      Odenwaldkreis;40 bis unter 45 Jahre;7249;3600;3649
06437;      Odenwaldkreis;45 bis unter 50 Jahre;8249;4151;4098
06437;      Odenwaldkreis;50 bis unter 55 Jahre;7769;3952;3817
06437;      Odenwaldkreis;55 bis unter 60 Jahre;7008;3485;3523
06437;      Odenwaldkreis;60 bis unter 65 Jahre;6574;3306;3268
06437;      Odenwaldkreis;65 bis unter 75 Jahre;10676;5214;5462
06437;      Odenwaldkreis;75 Jahre und mehr;10024;4013;6011
06437;      Odenwaldkreis;Insgesamt;96796;47861;48935
06438;      Offenbach, Landkreis;unter 3 Jahre;8888;4606;4282
06438;      Offenbach, Landkreis;3 bis unter 6 Jahre;9162;4660;4502
06438;      Offenbach, Landkreis;6 bis unter 10 Jahre;12565;6526;6039
06438;      Offenbach, Landkreis;10 bis unter 15 Jahre;16463;8490;7973
06438;      Offenbach, Landkreis;15 bis unter 18 Jahre;10116;5250;4866
06438;      Offenbach, Landkreis;18 bis unter 20 Jahre;6908;3463;3445
06438;      Offenbach, Landkreis;20 bis unter 25 Jahre;18301;9347;8954
06438;      Offenbach, Landkreis;25 bis unter 30 Jahre;19100;9430;9670
06438;      Offenbach, Landkreis;30 bis unter 35 Jahre;20848;10259;10589
06438;      Offenbach, Landkreis;35 bis unter 40 Jahre;21076;10443;10633
06438;      Offenbach, Landkreis;40 bis unter 45 Jahre;27281;13781;13500
06438;      Offenbach, Landkreis;45 bis unter 50 Jahre;30041;15345;14696
06438;      Offenbach, Landkreis;50 bis unter 55 Jahre;25717;12959;12758
06438;      Offenbach, Landkreis;55 bis unter 60 Jahre;22710;11066;11644
06438;      Offenbach, Landkreis;60 bis unter 65 Jahre;21564;10309;11255
06438;      Offenbach, Landkreis;65 bis unter 75 Jahre;38503;18429;20074
06438;      Offenbach, Landkreis;75 Jahre und mehr;30871;12709;18162
06438;      Offenbach, Landkreis;Insgesamt;340114;167072;173042
06439;      Rheingau-Taunus-Kreis;unter 3 Jahre;4052;2074;1978
06439;      Rheingau-Taunus-Kreis;3 bis unter 6 Jahre;4543;2379;2164
06439;      Rheingau-Taunus-Kreis;6 bis unter 10 Jahre;6623;3449;3174
06439;      Rheingau-Taunus-Kreis;10 bis unter 15 Jahre;9533;4755;4778
06439;      Rheingau-Taunus-Kreis;15 bis unter 18 Jahre;5767;2941;2826
06439;      Rheingau-Taunus-Kreis;18 bis unter 20 Jahre;3940;2067;1873
06439;      Rheingau-Taunus-Kreis;20 bis unter 25 Jahre;9054;4782;4272
06439;      Rheingau-Taunus-Kreis;25 bis unter 30 Jahre;8510;4366;4144
06439;      Rheingau-Taunus-Kreis;30 bis unter 35 Jahre;9431;4570;4861
06439;      Rheingau-Taunus-Kreis;35 bis unter 40 Jahre;10476;5061;5415
06439;      Rheingau-Taunus-Kreis;40 bis unter 45 Jahre;15285;7641;7644
06439;      Rheingau-Taunus-Kreis;45 bis unter 50 Jahre;17386;8813;8573
06439;      Rheingau-Taunus-Kreis;50 bis unter 55 Jahre;15010;7482;7528
06439;      Rheingau-Taunus-Kreis;55 bis unter 60 Jahre;12471;6146;6325
06439;      Rheingau-Taunus-Kreis;60 bis unter 65 Jahre;12214;6006;6208
06439;      Rheingau-Taunus-Kreis;65 bis unter 75 Jahre;21543;10396;11147
06439;      Rheingau-Taunus-Kreis;75 Jahre und mehr;17341;7061;10280
06439;      Rheingau-Taunus-Kreis;Insgesamt;183179;89989;93190
06440;      Wetteraukreis;unter 3 Jahre;7134;3670;3464
06440;      Wetteraukreis;3 bis unter 6 Jahre;7593;3935;3658
06440;      Wetteraukreis;6 bis unter 10 Jahre;10820;5501;5319
06440;      Wetteraukreis;10 bis unter 15 Jahre;15693;7910;7783
06440;      Wetteraukreis;15 bis unter 18 Jahre;9833;5023;4810
06440;      Wetteraukreis;18 bis unter 20 Jahre;6479;3322;3157
06440;      Wetteraukreis;20 bis unter 25 Jahre;16102;8483;7619
06440;      Wetteraukreis;25 bis unter 30 Jahre;15234;7699;7535
06440;      Wetteraukreis;30 bis unter 35 Jahre;16608;8075;8533
06440;      Wetteraukreis;35 bis unter 40 Jahre;17924;8853;9071
06440;      Wetteraukreis;40 bis unter 45 Jahre;25047;12616;12431
06440;      Wetteraukreis;45 bis unter 50 Jahre;27570;14061;13509
06440;      Wetteraukreis;50 bis unter 55 Jahre;23752;12053;11699
06440;      Wetteraukreis;55 bis unter 60 Jahre;20228;10204;10024
06440;      Wetteraukreis;60 bis unter 65 Jahre;18418;9211;9207
06440;      Wetteraukreis;65 bis unter 75 Jahre;32208;15527;16681
06440;      Wetteraukreis;75 Jahre und mehr;27786;10930;16856
06440;      Wetteraukreis;Insgesamt;298429;147073;151356
065;    Gießen, Regierungsbezirk;unter 3 Jahre;24541;12492;12049
065;    Gießen, Regierungsbezirk;3 bis unter 6 Jahre;25387;13083;12304
065;    Gießen, Regierungsbezirk;6 bis unter 10 Jahre;35886;18424;17462
065;    Gießen, Regierungsbezirk;10 bis unter 15 Jahre;52089;26655;25434
065;    Gießen, Regierungsbezirk;15 bis unter 18 Jahre;33426;17078;16348
065;    Gießen, Regierungsbezirk;18 bis unter 20 Jahre;24199;12239;11960
065;    Gießen, Regierungsbezirk;20 bis unter 25 Jahre;70910;34997;35913
065;    Gießen, Regierungsbezirk;25 bis unter 30 Jahre;63782;32321;31461
065;    Gießen, Regierungsbezirk;30 bis unter 35 Jahre;58630;29717;28913
065;    Gießen, Regierungsbezirk;35 bis unter 40 Jahre;58579;29175;29404
065;    Gießen, Regierungsbezirk;40 bis unter 45 Jahre;78332;39268;39064
065;    Gießen, Regierungsbezirk;45 bis unter 50 Jahre;92203;46786;45417
065;    Gießen, Regierungsbezirk;50 bis unter 55 Jahre;83983;42436;41547
065;    Gießen, Regierungsbezirk;55 bis unter 60 Jahre;70132;35186;34946
065;    Gießen, Regierungsbezirk;60 bis unter 65 Jahre;62775;31405;31370
065;    Gießen, Regierungsbezirk;65 bis unter 75 Jahre;104858;50196;54662
065;    Gießen, Regierungsbezirk;75 Jahre und mehr;99908;39088;60820
065;    Gießen, Regierungsbezirk;Insgesamt;1039620;510546;529074
06531;      Gießen, Landkreis;unter 3 Jahre;6194;3174;3020
06531;      Gießen, Landkreis;3 bis unter 6 Jahre;6223;3084;3139
06531;      Gießen, Landkreis;6 bis unter 10 Jahre;8571;4398;4173
06531;      Gießen, Landkreis;10 bis unter 15 Jahre;12002;6262;5740
06531;      Gießen, Landkreis;15 bis unter 18 Jahre;7628;3975;3653
06531;      Gießen, Landkreis;18 bis unter 20 Jahre;5795;2961;2834
06531;      Gießen, Landkreis;20 bis unter 25 Jahre;20590;9764;10826
06531;      Gießen, Landkreis;25 bis unter 30 Jahre;18509;9198;9311
06531;      Gießen, Landkreis;30 bis unter 35 Jahre;15719;7978;7741
06531;      Gießen, Landkreis;35 bis unter 40 Jahre;14485;7247;7238
06531;      Gießen, Landkreis;40 bis unter 45 Jahre;18685;9326;9359
06531;      Gießen, Landkreis;45 bis unter 50 Jahre;22927;11248;11679
06531;      Gießen, Landkreis;50 bis unter 55 Jahre;20577;10337;10240
06531;      Gießen, Landkreis;55 bis unter 60 Jahre;16720;8374;8346
06531;      Gießen, Landkreis;60 bis unter 65 Jahre;15047;7448;7599
06531;      Gießen, Landkreis;65 bis unter 75 Jahre;24358;11737;12621
06531;      Gießen, Landkreis;75 Jahre und mehr;23357;9095;14262
06531;      Gießen, Landkreis;Insgesamt;257387;125606;131781
06532;      Lahn-Dill-Kreis;unter 3 Jahre;6162;3197;2965
06532;      Lahn-Dill-Kreis;3 bis unter 6 Jahre;6286;3315;2971
06532;      Lahn-Dill-Kreis;6 bis unter 10 Jahre;9023;4634;4389
06532;      Lahn-Dill-Kreis;10 bis unter 15 Jahre;13190;6713;6477
06532;      Lahn-Dill-Kreis;15 bis unter 18 Jahre;8724;4422;4302
06532;      Lahn-Dill-Kreis;18 bis unter 20 Jahre;6053;3069;2984
06532;      Lahn-Dill-Kreis;20 bis unter 25 Jahre;14702;7763;6939
06532;      Lahn-Dill-Kreis;25 bis unter 30 Jahre;13706;6978;6728
06532;      Lahn-Dill-Kreis;30 bis unter 35 Jahre;13771;6874;6897
06532;      Lahn-Dill-Kreis;35 bis unter 40 Jahre;14309;7033;7276
06532;      Lahn-Dill-Kreis;40 bis unter 45 Jahre;19630;9865;9765
06532;      Lahn-Dill-Kreis;45 bis unter 50 Jahre;21856;11153;10703
06532;      Lahn-Dill-Kreis;50 bis unter 55 Jahre;19836;10008;9828
06532;      Lahn-Dill-Kreis;55 bis unter 60 Jahre;17000;8399;8601
06532;      Lahn-Dill-Kreis;60 bis unter 65 Jahre;15707;7797;7910
06532;      Lahn-Dill-Kreis;65 bis unter 75 Jahre;27386;13017;14369
06532;      Lahn-Dill-Kreis;75 Jahre und mehr;25136;9617;15519
06532;      Lahn-Dill-Kreis;Insgesamt;252477;123854;128623
06533;      Limburg-Weilburg, Landkreis;unter 3 Jahre;4091;2013;2078
06533;      Limburg-Weilburg, Landkreis;3 bis unter 6 Jahre;4459;2344;2115
06533;      Limburg-Weilburg, Landkreis;6 bis unter 10 Jahre;6397;3278;3119
06533;      Limburg-Weilburg, Landkreis;10 bis unter 15 Jahre;9396;4748;4648
06533;      Limburg-Weilburg, Landkreis;15 bis unter 18 Jahre;5826;2952;2874
06533;      Limburg-Weilburg, Landkreis;18 bis unter 20 Jahre;4036;2078;1958
06533;      Limburg-Weilburg, Landkreis;20 bis unter 25 Jahre;9838;5210;4628
06533;      Limburg-Weilburg, Landkreis;25 bis unter 30 Jahre;9016;4603;4413
06533;      Limburg-Weilburg, Landkreis;30 bis unter 35 Jahre;9181;4610;4571
06533;      Limburg-Weilburg, Landkreis;35 bis unter 40 Jahre;9569;4748;4821
06533;      Limburg-Weilburg, Landkreis;40 bis unter 45 Jahre;13366;6572;6794
06533;      Limburg-Weilburg, Landkreis;45 bis unter 50 Jahre;15058;7743;7315
06533;      Limburg-Weilburg, Landkreis;50 bis unter 55 Jahre;13768;6944;6824
06533;      Limburg-Weilburg, Landkreis;55 bis unter 60 Jahre;11914;6008;5906
06533;      Limburg-Weilburg, Landkreis;60 bis unter 65 Jahre;10453;5214;5239
06533;      Limburg-Weilburg, Landkreis;65 bis unter 75 Jahre;17729;8510;9219
06533;      Limburg-Weilburg, Landkreis;75 Jahre und mehr;16260;6344;9916
06533;      Limburg-Weilburg, Landkreis;Insgesamt;170357;83919;86438
06534;      Marburg-Biedenkopf, Landkreis;unter 3 Jahre;5821;2952;2869
06534;      Marburg-Biedenkopf, Landkreis;3 bis unter 6 Jahre;6093;3145;2948
06534;      Marburg-Biedenkopf, Landkreis;6 bis unter 10 Jahre;8422;4347;4075
06534;      Marburg-Biedenkopf, Landkreis;10 bis unter 15 Jahre;12119;6199;5920
06534;      Marburg-Biedenkopf, Landkreis;15 bis unter 18 Jahre;7720;3929;3791
06534;      Marburg-Biedenkopf, Landkreis;18 bis unter 20 Jahre;5849;2863;2986
06534;      Marburg-Biedenkopf, Landkreis;20 bis unter 25 Jahre;20066;9306;10760
06534;      Marburg-Biedenkopf, Landkreis;25 bis unter 30 Jahre;17346;8731;8615
06534;      Marburg-Biedenkopf, Landkreis;30 bis unter 35 Jahre;14490;7525;6965
06534;      Marburg-Biedenkopf, Landkreis;35 bis unter 40 Jahre;14155;7123;7032
06534;      Marburg-Biedenkopf, Landkreis;40 bis unter 45 Jahre;18573;9364;9209
06534;      Marburg-Biedenkopf, Landkreis;45 bis unter 50 Jahre;23150;11823;11327
06534;      Marburg-Biedenkopf, Landkreis;50 bis unter 55 Jahre;20495;10446;10049
06534;      Marburg-Biedenkopf, Landkreis;55 bis unter 60 Jahre;16405;8228;8177
06534;      Marburg-Biedenkopf, Landkreis;60 bis unter 65 Jahre;14215;7119;7096
06534;      Marburg-Biedenkopf, Landkreis;65 bis unter 75 Jahre;23710;11283;12427
06534;      Marburg-Biedenkopf, Landkreis;75 Jahre und mehr;22232;8787;13445
06534;      Marburg-Biedenkopf, Landkreis;Insgesamt;250861;123170;127691
06535;      Vogelsbergkreis;unter 3 Jahre;2273;1156;1117
06535;      Vogelsbergkreis;3 bis unter 6 Jahre;2326;1195;1131
06535;      Vogelsbergkreis;6 bis unter 10 Jahre;3473;1767;1706
06535;      Vogelsbergkreis;10 bis unter 15 Jahre;5382;2733;2649
06535;      Vogelsbergkreis;15 bis unter 18 Jahre;3528;1800;1728
06535;      Vogelsbergkreis;18 bis unter 20 Jahre;2466;1268;1198
06535;      Vogelsbergkreis;20 bis unter 25 Jahre;5714;2954;2760
06535;      Vogelsbergkreis;25 bis unter 30 Jahre;5205;2811;2394
06535;      Vogelsbergkreis;30 bis unter 35 Jahre;5469;2730;2739
06535;      Vogelsbergkreis;35 bis unter 40 Jahre;6061;3024;3037
06535;      Vogelsbergkreis;40 bis unter 45 Jahre;8078;4141;3937
06535;      Vogelsbergkreis;45 bis unter 50 Jahre;9212;4819;4393
06535;      Vogelsbergkreis;50 bis unter 55 Jahre;9307;4701;4606
06535;      Vogelsbergkreis;55 bis unter 60 Jahre;8093;4177;3916
06535;      Vogelsbergkreis;60 bis unter 65 Jahre;7353;3827;3526
06535;      Vogelsbergkreis;65 bis unter 75 Jahre;11675;5649;6026
06535;      Vogelsbergkreis;75 Jahre und mehr;12923;5245;7678
06535;      Vogelsbergkreis;Insgesamt;108538;53997;54541
066;    Kassel, Regierungsbezirk;unter 3 Jahre;27907;14403;13504
066;    Kassel, Regierungsbezirk;3 bis unter 6 Jahre;28963;14805;14158
066;    Kassel, Regierungsbezirk;6 bis unter 10 Jahre;41594;21199;20395
066;    Kassel, Regierungsbezirk;10 bis unter 15 Jahre;60636;31268;29368
066;    Kassel, Regierungsbezirk;15 bis unter 18 Jahre;39136;19944;19192
066;    Kassel, Regierungsbezirk;18 bis unter 20 Jahre;27673;14273;13400
066;    Kassel, Regierungsbezirk;20 bis unter 25 Jahre;71587;36715;34872
066;    Kassel, Regierungsbezirk;25 bis unter 30 Jahre;67460;35050;32410
066;    Kassel, Regierungsbezirk;30 bis unter 35 Jahre;65443;33007;32436
066;    Kassel, Regierungsbezirk;35 bis unter 40 Jahre;67578;33404;34174
066;    Kassel, Regierungsbezirk;40 bis unter 45 Jahre;93624;47457;46167
066;    Kassel, Regierungsbezirk;45 bis unter 50 Jahre;102964;52536;50428
066;    Kassel, Regierungsbezirk;50 bis unter 55 Jahre;95316;47869;47447
066;    Kassel, Regierungsbezirk;55 bis unter 60 Jahre;83877;41871;42006
066;    Kassel, Regierungsbezirk;60 bis unter 65 Jahre;77162;38217;38945
066;    Kassel, Regierungsbezirk;65 bis unter 75 Jahre;136942;65519;71423
066;    Kassel, Regierungsbezirk;75 Jahre und mehr;129052;49357;79695
066;    Kassel, Regierungsbezirk;Insgesamt;1216914;596894;620020
06611;      Kassel, Kreisfreie Stadt;unter 3 Jahre;5101;2640;2461
06611;      Kassel, Kreisfreie Stadt;3 bis unter 6 Jahre;4817;2457;2360
06611;      Kassel, Kreisfreie Stadt;6 bis unter 10 Jahre;6239;3215;3024
06611;      Kassel, Kreisfreie Stadt;10 bis unter 15 Jahre;8318;4276;4042
06611;      Kassel, Kreisfreie Stadt;15 bis unter 18 Jahre;5166;2566;2600
06611;      Kassel, Kreisfreie Stadt;18 bis unter 20 Jahre;4164;2048;2116
06611;      Kassel, Kreisfreie Stadt;20 bis unter 25 Jahre;15622;7362;8260
06611;      Kassel, Kreisfreie Stadt;25 bis unter 30 Jahre;15306;8012;7294
06611;      Kassel, Kreisfreie Stadt;30 bis unter 35 Jahre;13098;6732;6366
06611;      Kassel, Kreisfreie Stadt;35 bis unter 40 Jahre;11188;5585;5603
06611;      Kassel, Kreisfreie Stadt;40 bis unter 45 Jahre;13901;7082;6819
06611;      Kassel, Kreisfreie Stadt;45 bis unter 50 Jahre;15721;7882;7839
06611;      Kassel, Kreisfreie Stadt;50 bis unter 55 Jahre;14570;7269;7301
06611;      Kassel, Kreisfreie Stadt;55 bis unter 60 Jahre;12376;6013;6363
06611;      Kassel, Kreisfreie Stadt;60 bis unter 65 Jahre;11296;5511;5785
06611;      Kassel, Kreisfreie Stadt;65 bis unter 75 Jahre;20253;9289;10964
06611;      Kassel, Kreisfreie Stadt;75 Jahre und mehr;19390;6851;12539
06611;      Kassel, Kreisfreie Stadt;Insgesamt;196526;94790;101736
06631;      Fulda, Landkreis;unter 3 Jahre;5414;2787;2627
06631;      Fulda, Landkreis;3 bis unter 6 Jahre;5556;2848;2708
06631;      Fulda, Landkreis;6 bis unter 10 Jahre;8255;4200;4055
06631;      Fulda, Landkreis;10 bis unter 15 Jahre;12151;6237;5914
06631;      Fulda, Landkreis;15 bis unter 18 Jahre;7739;3970;3769
06631;      Fulda, Landkreis;18 bis unter 20 Jahre;5398;2786;2612
06631;      Fulda, Landkreis;20 bis unter 25 Jahre;13142;6613;6529
06631;      Fulda, Landkreis;25 bis unter 30 Jahre;12505;6360;6145
06631;      Fulda, Landkreis;30 bis unter 35 Jahre;12084;6116;5968
06631;      Fulda, Landkreis;35 bis unter 40 Jahre;12356;6045;6311
06631;      Fulda, Landkreis;40 bis unter 45 Jahre;16902;8637;8265
06631;      Fulda, Landkreis;45 bis unter 50 Jahre;18783;9523;9260
06631;      Fulda, Landkreis;50 bis unter 55 Jahre;16337;8192;8145
06631;      Fulda, Landkreis;55 bis unter 60 Jahre;14229;7254;6975
06631;      Fulda, Landkreis;60 bis unter 65 Jahre;12253;5976;6277
06631;      Fulda, Landkreis;65 bis unter 75 Jahre;22041;10544;11497
06631;      Fulda, Landkreis;75 Jahre und mehr;21572;8370;13202
06631;      Fulda, Landkreis;Insgesamt;216717;106458;110259
06632;      Hersfeld-Rotenburg, Landkreis;unter 3 Jahre;2728;1434;1294
06632;      Hersfeld-Rotenburg, Landkreis;3 bis unter 6 Jahre;2955;1549;1406
06632;      Hersfeld-Rotenburg, Landkreis;6 bis unter 10 Jahre;4103;2045;2058
06632;      Hersfeld-Rotenburg, Landkreis;10 bis unter 15 Jahre;5912;3077;2835
06632;      Hersfeld-Rotenburg, Landkreis;15 bis unter 18 Jahre;3735;1848;1887
06632;      Hersfeld-Rotenburg, Landkreis;18 bis unter 20 Jahre;2604;1359;1245
06632;      Hersfeld-Rotenburg, Landkreis;20 bis unter 25 Jahre;6588;3544;3044
06632;      Hersfeld-Rotenburg, Landkreis;25 bis unter 30 Jahre;6298;3349;2949
06632;      Hersfeld-Rotenburg, Landkreis;30 bis unter 35 Jahre;6327;3278;3049
06632;      Hersfeld-Rotenburg, Landkreis;35 bis unter 40 Jahre;6669;3399;3270
06632;      Hersfeld-Rotenburg, Landkreis;40 bis unter 45 Jahre;9391;4795;4596
06632;      Hersfeld-Rotenburg, Landkreis;45 bis unter 50 Jahre;9948;5116;4832
06632;      Hersfeld-Rotenburg, Landkreis;50 bis unter 55 Jahre;9605;4853;4752
06632;      Hersfeld-Rotenburg, Landkreis;55 bis unter 60 Jahre;8831;4331;4500
06632;      Hersfeld-Rotenburg, Landkreis;60 bis unter 65 Jahre;7986;4025;3961
06632;      Hersfeld-Rotenburg, Landkreis;65 bis unter 75 Jahre;14277;6892;7385
06632;      Hersfeld-Rotenburg, Landkreis;75 Jahre und mehr;14124;5611;8513
06632;      Hersfeld-Rotenburg, Landkreis;Insgesamt;122081;60505;61576
06633;      Kassel, Landkreis;unter 3 Jahre;4992;2591;2401
06633;      Kassel, Landkreis;3 bis unter 6 Jahre;5324;2670;2654
06633;      Kassel, Landkreis;6 bis unter 10 Jahre;7860;3957;3903
06633;      Kassel, Landkreis;10 bis unter 15 Jahre;11942;6210;5732
06633;      Kassel, Landkreis;15 bis unter 18 Jahre;7672;3913;3759
06633;      Kassel, Landkreis;18 bis unter 20 Jahre;5198;2715;2483
06633;      Kassel, Landkreis;20 bis unter 25 Jahre;11982;6271;5711
06633;      Kassel, Landkreis;25 bis unter 30 Jahre;10900;5583;5317
06633;      Kassel, Landkreis;30 bis unter 35 Jahre;11416;5508;5908
06633;      Kassel, Landkreis;35 bis unter 40 Jahre;12995;6307;6688
06633;      Kassel, Landkreis;40 bis unter 45 Jahre;18807;9322;9485
06633;      Kassel, Landkreis;45 bis unter 50 Jahre;20556;10404;10152
06633;      Kassel, Landkreis;50 bis unter 55 Jahre;18796;9332;9464
06633;      Kassel, Landkreis;55 bis unter 60 Jahre;16733;8248;8485
06633;      Kassel, Landkreis;60 bis unter 65 Jahre;16467;8054;8413
06633;      Kassel, Landkreis;65 bis unter 75 Jahre;29709;14469;15240
06633;      Kassel, Landkreis;75 Jahre und mehr;25038;9677;15361
06633;      Kassel, Landkreis;Insgesamt;236387;115231;121156
06634;      Schwalm-Eder-Kreis;unter 3 Jahre;3976;2023;1953
06634;      Schwalm-Eder-Kreis;3 bis unter 6 Jahre;4201;2158;2043
06634;      Schwalm-Eder-Kreis;6 bis unter 10 Jahre;6191;3204;2987
06634;      Schwalm-Eder-Kreis;10 bis unter 15 Jahre;9145;4685;4460
06634;      Schwalm-Eder-Kreis;15 bis unter 18 Jahre;5999;3123;2876
06634;      Schwalm-Eder-Kreis;18 bis unter 20 Jahre;4277;2227;2050
06634;      Schwalm-Eder-Kreis;20 bis unter 25 Jahre;10098;5397;4701
06634;      Schwalm-Eder-Kreis;25 bis unter 30 Jahre;9191;4815;4376
06634;      Schwalm-Eder-Kreis;30 bis unter 35 Jahre;9451;4809;4642
06634;      Schwalm-Eder-Kreis;35 bis unter 40 Jahre;10238;5083;5155
06634;      Schwalm-Eder-Kreis;40 bis unter 45 Jahre;14274;7276;6998
06634;      Schwalm-Eder-Kreis;45 bis unter 50 Jahre;15469;7881;7588
06634;      Schwalm-Eder-Kreis;50 bis unter 55 Jahre;14658;7444;7214
06634;      Schwalm-Eder-Kreis;55 bis unter 60 Jahre;12973;6548;6425
06634;      Schwalm-Eder-Kreis;60 bis unter 65 Jahre;11932;6068;5864
06634;      Schwalm-Eder-Kreis;65 bis unter 75 Jahre;20380;9869;10511
06634;      Schwalm-Eder-Kreis;75 Jahre und mehr;19070;7375;11695
06634;      Schwalm-Eder-Kreis;Insgesamt;181523;89985;91538
06635;      Waldeck-Frankenberg, Landkreis;unter 3 Jahre;3578;1843;1735
06635;      Waldeck-Frankenberg, Landkreis;3 bis unter 6 Jahre;3932;2026;1906
06635;      Waldeck-Frankenberg, Landkreis;6 bis unter 10 Jahre;5655;2879;2776
06635;      Waldeck-Frankenberg, Landkreis;10 bis unter 15 Jahre;8397;4351;4046
06635;      Waldeck-Frankenberg, Landkreis;15 bis unter 18 Jahre;5517;2810;2707
06635;      Waldeck-Frankenberg, Landkreis;18 bis unter 20 Jahre;3827;1991;1836
06635;      Waldeck-Frankenberg, Landkreis;20 bis unter 25 Jahre;8798;4721;4077
06635;      Waldeck-Frankenberg, Landkreis;25 bis unter 30 Jahre;8270;4342;3928
06635;      Waldeck-Frankenberg, Landkreis;30 bis unter 35 Jahre;8224;4039;4185
06635;      Waldeck-Frankenberg, Landkreis;35 bis unter 40 Jahre;8785;4309;4476
06635;      Waldeck-Frankenberg, Landkreis;40 bis unter 45 Jahre;12412;6326;6086
06635;      Waldeck-Frankenberg, Landkreis;45 bis unter 50 Jahre;13684;7147;6537
06635;      Waldeck-Frankenberg, Landkreis;50 bis unter 55 Jahre;12901;6521;6380
06635;      Waldeck-Frankenberg, Landkreis;55 bis unter 60 Jahre;11243;5651;5592
06635;      Waldeck-Frankenberg, Landkreis;60 bis unter 65 Jahre;10115;5079;5036
06635;      Waldeck-Frankenberg, Landkreis;65 bis unter 75 Jahre;17696;8454;9242
06635;      Waldeck-Frankenberg, Landkreis;75 Jahre und mehr;17537;6742;10795
06635;      Waldeck-Frankenberg, Landkreis;Insgesamt;160571;79231;81340
06636;      Werra-Meißner-Kreis;unter 3 Jahre;2118;1085;1033
06636;      Werra-Meißner-Kreis;3 bis unter 6 Jahre;2178;1097;1081
06636;      Werra-Meißner-Kreis;6 bis unter 10 Jahre;3291;1699;1592
06636;      Werra-Meißner-Kreis;10 bis unter 15 Jahre;4771;2432;2339
06636;      Werra-Meißner-Kreis;15 bis unter 18 Jahre;3308;1714;1594
06636;      Werra-Meißner-Kreis;18 bis unter 20 Jahre;2205;1147;1058
06636;      Werra-Meißner-Kreis;20 bis unter 25 Jahre;5357;2807;2550
06636;      Werra-Meißner-Kreis;25 bis unter 30 Jahre;4990;2589;2401
06636;      Werra-Meißner-Kreis;30 bis unter 35 Jahre;4843;2525;2318
06636;      Werra-Meißner-Kreis;35 bis unter 40 Jahre;5347;2676;2671
06636;      Werra-Meißner-Kreis;40 bis unter 45 Jahre;7937;4019;3918
06636;      Werra-Meißner-Kreis;45 bis unter 50 Jahre;8803;4583;4220
06636;      Werra-Meißner-Kreis;50 bis unter 55 Jahre;8449;4258;4191
06636;      Werra-Meißner-Kreis;55 bis unter 60 Jahre;7492;3826;3666
06636;      Werra-Meißner-Kreis;60 bis unter 65 Jahre;7113;3504;3609
06636;      Werra-Meißner-Kreis;65 bis unter 75 Jahre;12586;6002;6584
06636;      Werra-Meißner-Kreis;75 Jahre und mehr;12321;4731;7590
06636;      Werra-Meißner-Kreis;Insgesamt;103109;50694;52415
07;  Rheinland-Pfalz;unter 3 Jahre;94786;48649;46137
07;  Rheinland-Pfalz;3 bis unter 6 Jahre;98463;50758;47705
07;  Rheinland-Pfalz;6 bis unter 10 Jahre;138169;71089;67080
07;  Rheinland-Pfalz;10 bis unter 15 Jahre;200021;102557;97464
07;  Rheinland-Pfalz;15 bis unter 18 Jahre;127266;65467;61799
07;  Rheinland-Pfalz;18 bis unter 20 Jahre;91541;46893;44648
07;  Rheinland-Pfalz;20 bis unter 25 Jahre;244412;124795;119617
07;  Rheinland-Pfalz;25 bis unter 30 Jahre;228447;116175;112272
07;  Rheinland-Pfalz;30 bis unter 35 Jahre;222325;110911;111414
07;  Rheinland-Pfalz;35 bis unter 40 Jahre;222498;111002;111496
07;  Rheinland-Pfalz;40 bis unter 45 Jahre;305472;154588;150884
07;  Rheinland-Pfalz;45 bis unter 50 Jahre;348946;178133;170813
07;  Rheinland-Pfalz;50 bis unter 55 Jahre;324950;164099;160851
07;  Rheinland-Pfalz;55 bis unter 60 Jahre;282914;141793;141121
07;  Rheinland-Pfalz;60 bis unter 65 Jahre;246057;122826;123231
07;  Rheinland-Pfalz;65 bis unter 75 Jahre;422973;201590;221383
07;  Rheinland-Pfalz;75 Jahre und mehr;399877;155570;244307
07;  Rheinland-Pfalz;Insgesamt;3999117;1966895;2032222
071;    Koblenz, Stat. Region;unter 3 Jahre;34085;17450;16635
071;    Koblenz, Stat. Region;3 bis unter 6 Jahre;36140;18557;17583
071;    Koblenz, Stat. Region;6 bis unter 10 Jahre;51684;26539;25145
071;    Koblenz, Stat. Region;10 bis unter 15 Jahre;76115;39137;36978
071;    Koblenz, Stat. Region;15 bis unter 18 Jahre;48686;25225;23461
071;    Koblenz, Stat. Region;18 bis unter 20 Jahre;34637;17869;16768
071;    Koblenz, Stat. Region;20 bis unter 25 Jahre;85007;44557;40450
071;    Koblenz, Stat. Region;25 bis unter 30 Jahre;78487;40313;38174
071;    Koblenz, Stat. Region;30 bis unter 35 Jahre;78344;38906;39438
071;    Koblenz, Stat. Region;35 bis unter 40 Jahre;79616;39721;39895
071;    Koblenz, Stat. Region;40 bis unter 45 Jahre;111580;56254;55326
071;    Koblenz, Stat. Region;45 bis unter 50 Jahre;127977;65070;62907
071;    Koblenz, Stat. Region;50 bis unter 55 Jahre;119842;60375;59467
071;    Koblenz, Stat. Region;55 bis unter 60 Jahre;105600;52676;52924
071;    Koblenz, Stat. Region;60 bis unter 65 Jahre;93290;46731;46559
071;    Koblenz, Stat. Region;65 bis unter 75 Jahre;161606;76955;84651
071;    Koblenz, Stat. Region;75 Jahre und mehr;154593;60027;94566
071;    Koblenz, Stat. Region;Insgesamt;1477289;726362;750927
07111;      Koblenz, Kreisfreie Stadt;unter 3 Jahre;2749;1414;1335
07111;      Koblenz, Kreisfreie Stadt;3 bis unter 6 Jahre;2598;1303;1295
07111;      Koblenz, Kreisfreie Stadt;6 bis unter 10 Jahre;3316;1744;1572
07111;      Koblenz, Kreisfreie Stadt;10 bis unter 15 Jahre;4460;2279;2181
07111;      Koblenz, Kreisfreie Stadt;15 bis unter 18 Jahre;2858;1459;1399
07111;      Koblenz, Kreisfreie Stadt;18 bis unter 20 Jahre;2131;1059;1072
07111;      Koblenz, Kreisfreie Stadt;20 bis unter 25 Jahre;7143;3359;3784
07111;      Koblenz, Kreisfreie Stadt;25 bis unter 30 Jahre;7827;3949;3878
07111;      Koblenz, Kreisfreie Stadt;30 bis unter 35 Jahre;7171;3739;3432
07111;      Koblenz, Kreisfreie Stadt;35 bis unter 40 Jahre;6094;3113;2981
07111;      Koblenz, Kreisfreie Stadt;40 bis unter 45 Jahre;7712;3965;3747
07111;      Koblenz, Kreisfreie Stadt;45 bis unter 50 Jahre;8119;4081;4038
07111;      Koblenz, Kreisfreie Stadt;50 bis unter 55 Jahre;7656;3856;3800
07111;      Koblenz, Kreisfreie Stadt;55 bis unter 60 Jahre;6982;3364;3618
07111;      Koblenz, Kreisfreie Stadt;60 bis unter 65 Jahre;6329;2942;3387
07111;      Koblenz, Kreisfreie Stadt;65 bis unter 75 Jahre;11826;5483;6343
07111;      Koblenz, Kreisfreie Stadt;75 Jahre und mehr;11706;4203;7503
07111;      Koblenz, Kreisfreie Stadt;Insgesamt;106677;51312;55365
07131;      Ahrweiler, Landkreis;unter 3 Jahre;2685;1351;1334
07131;      Ahrweiler, Landkreis;3 bis unter 6 Jahre;2775;1465;1310
07131;      Ahrweiler, Landkreis;6 bis unter 10 Jahre;4142;2071;2071
07131;      Ahrweiler, Landkreis;10 bis unter 15 Jahre;6536;3340;3196
07131;      Ahrweiler, Landkreis;15 bis unter 18 Jahre;4242;2210;2032
07131;      Ahrweiler, Landkreis;18 bis unter 20 Jahre;2939;1490;1449
07131;      Ahrweiler, Landkreis;20 bis unter 25 Jahre;7050;3716;3334
07131;      Ahrweiler, Landkreis;25 bis unter 30 Jahre;6160;3212;2948
07131;      Ahrweiler, Landkreis;30 bis unter 35 Jahre;6066;2965;3101
07131;      Ahrweiler, Landkreis;35 bis unter 40 Jahre;6291;3087;3204
07131;      Ahrweiler, Landkreis;40 bis unter 45 Jahre;9672;4834;4838
07131;      Ahrweiler, Landkreis;45 bis unter 50 Jahre;11541;5881;5660
07131;      Ahrweiler, Landkreis;50 bis unter 55 Jahre;10521;5321;5200
07131;      Ahrweiler, Landkreis;55 bis unter 60 Jahre;9006;4564;4442
07131;      Ahrweiler, Landkreis;60 bis unter 65 Jahre;8034;3978;4056
07131;      Ahrweiler, Landkreis;65 bis unter 75 Jahre;15237;7167;8070
07131;      Ahrweiler, Landkreis;75 Jahre und mehr;14264;5593;8671
07131;      Ahrweiler, Landkreis;Insgesamt;127161;62245;64916
07132;      Altenkirchen (Westerwald), Landkreis;unter 3 Jahre;2986;1552;1434
07132;      Altenkirchen (Westerwald), Landkreis;3 bis unter 6 Jahre;3309;1721;1588
07132;      Altenkirchen (Westerwald), Landkreis;6 bis unter 10 Jahre;4573;2363;2210
07132;      Altenkirchen (Westerwald), Landkreis;10 bis unter 15 Jahre;6907;3572;3335
07132;      Altenkirchen (Westerwald), Landkreis;15 bis unter 18 Jahre;4613;2431;2182
07132;      Altenkirchen (Westerwald), Landkreis;18 bis unter 20 Jahre;3342;1720;1622
07132;      Altenkirchen (Westerwald), Landkreis;20 bis unter 25 Jahre;7916;4190;3726
07132;      Altenkirchen (Westerwald), Landkreis;25 bis unter 30 Jahre;6902;3518;3384
07132;      Altenkirchen (Westerwald), Landkreis;30 bis unter 35 Jahre;6739;3351;3388
07132;      Altenkirchen (Westerwald), Landkreis;35 bis unter 40 Jahre;7091;3586;3505
07132;      Altenkirchen (Westerwald), Landkreis;40 bis unter 45 Jahre;9914;5128;4786
07132;      Altenkirchen (Westerwald), Landkreis;45 bis unter 50 Jahre;11387;5867;5520
07132;      Altenkirchen (Westerwald), Landkreis;50 bis unter 55 Jahre;10552;5373;5179
07132;      Altenkirchen (Westerwald), Landkreis;55 bis unter 60 Jahre;9215;4636;4579
07132;      Altenkirchen (Westerwald), Landkreis;60 bis unter 65 Jahre;7925;3948;3977
07132;      Altenkirchen (Westerwald), Landkreis;65 bis unter 75 Jahre;14057;6717;7340
07132;      Altenkirchen (Westerwald), Landkreis;75 Jahre und mehr;13422;5160;8262
07132;      Altenkirchen (Westerwald), Landkreis;Insgesamt;130850;64833;66017
07133;      Bad Kreuznach, Landkreis;unter 3 Jahre;3747;1872;1875
07133;      Bad Kreuznach, Landkreis;3 bis unter 6 Jahre;3841;1986;1855
07133;      Bad Kreuznach, Landkreis;6 bis unter 10 Jahre;5396;2741;2655
07133;      Bad Kreuznach, Landkreis;10 bis unter 15 Jahre;7879;4137;3742
07133;      Bad Kreuznach, Landkreis;15 bis unter 18 Jahre;4930;2544;2386
07133;      Bad Kreuznach, Landkreis;18 bis unter 20 Jahre;3586;1830;1756
07133;      Bad Kreuznach, Landkreis;20 bis unter 25 Jahre;8674;4581;4093
07133;      Bad Kreuznach, Landkreis;25 bis unter 30 Jahre;8081;4135;3946
07133;      Bad Kreuznach, Landkreis;30 bis unter 35 Jahre;8236;4064;4172
07133;      Bad Kreuznach, Landkreis;35 bis unter 40 Jahre;8549;4213;4336
07133;      Bad Kreuznach, Landkreis;40 bis unter 45 Jahre;11808;5996;5812
07133;      Bad Kreuznach, Landkreis;45 bis unter 50 Jahre;13409;6785;6624
07133;      Bad Kreuznach, Landkreis;50 bis unter 55 Jahre;12689;6296;6393
07133;      Bad Kreuznach, Landkreis;55 bis unter 60 Jahre;11243;5551;5692
07133;      Bad Kreuznach, Landkreis;60 bis unter 65 Jahre;10289;5126;5163
07133;      Bad Kreuznach, Landkreis;65 bis unter 75 Jahre;17204;8137;9067
07133;      Bad Kreuznach, Landkreis;75 Jahre und mehr;15840;6097;9743
07133;      Bad Kreuznach, Landkreis;Insgesamt;155401;76091;79310
07134;      Birkenfeld, Landkreis;unter 3 Jahre;1845;940;905
07134;      Birkenfeld, Landkreis;3 bis unter 6 Jahre;1945;1013;932
07134;      Birkenfeld, Landkreis;6 bis unter 10 Jahre;2714;1419;1295
07134;      Birkenfeld, Landkreis;10 bis unter 15 Jahre;3993;2109;1884
07134;      Birkenfeld, Landkreis;15 bis unter 18 Jahre;2592;1385;1207
07134;      Birkenfeld, Landkreis;18 bis unter 20 Jahre;1869;971;898
07134;      Birkenfeld, Landkreis;20 bis unter 25 Jahre;4687;2495;2192
07134;      Birkenfeld, Landkreis;25 bis unter 30 Jahre;4400;2211;2189
07134;      Birkenfeld, Landkreis;30 bis unter 35 Jahre;4139;2093;2046
07134;      Birkenfeld, Landkreis;35 bis unter 40 Jahre;4151;2054;2097
07134;      Birkenfeld, Landkreis;40 bis unter 45 Jahre;5722;2806;2916
07134;      Birkenfeld, Landkreis;45 bis unter 50 Jahre;6908;3542;3366
07134;      Birkenfeld, Landkreis;50 bis unter 55 Jahre;6902;3530;3372
07134;      Birkenfeld, Landkreis;55 bis unter 60 Jahre;6284;3126;3158
07134;      Birkenfeld, Landkreis;60 bis unter 65 Jahre;5588;2879;2709
07134;      Birkenfeld, Landkreis;65 bis unter 75 Jahre;9184;4361;4823
07134;      Birkenfeld, Landkreis;75 Jahre und mehr;9569;3776;5793
07134;      Birkenfeld, Landkreis;Insgesamt;82492;40710;41782
07135;      Cochem-Zell, Landkreis;unter 3 Jahre;1310;677;633
07135;      Cochem-Zell, Landkreis;3 bis unter 6 Jahre;1462;727;735
07135;      Cochem-Zell, Landkreis;6 bis unter 10 Jahre;2222;1147;1075
07135;      Cochem-Zell, Landkreis;10 bis unter 15 Jahre;3298;1741;1557
07135;      Cochem-Zell, Landkreis;15 bis unter 18 Jahre;2053;1033;1020
07135;      Cochem-Zell, Landkreis;18 bis unter 20 Jahre;1542;804;738
07135;      Cochem-Zell, Landkreis;20 bis unter 25 Jahre;3489;1891;1598
07135;      Cochem-Zell, Landkreis;25 bis unter 30 Jahre;3253;1796;1457
07135;      Cochem-Zell, Landkreis;30 bis unter 35 Jahre;3109;1538;1571
07135;      Cochem-Zell, Landkreis;35 bis unter 40 Jahre;3238;1617;1621
07135;      Cochem-Zell, Landkreis;40 bis unter 45 Jahre;4587;2332;2255
07135;      Cochem-Zell, Landkreis;45 bis unter 50 Jahre;5319;2784;2535
07135;      Cochem-Zell, Landkreis;50 bis unter 55 Jahre;4970;2530;2440
07135;      Cochem-Zell, Landkreis;55 bis unter 60 Jahre;4506;2264;2242
07135;      Cochem-Zell, Landkreis;60 bis unter 65 Jahre;4051;2059;1992
07135;      Cochem-Zell, Landkreis;65 bis unter 75 Jahre;7184;3449;3735
07135;      Cochem-Zell, Landkreis;75 Jahre und mehr;7356;2873;4483
07135;      Cochem-Zell, Landkreis;Insgesamt;62949;31262;31687
07137;      Mayen-Koblenz, Landkreis;unter 3 Jahre;4895;2505;2390
07137;      Mayen-Koblenz, Landkreis;3 bis unter 6 Jahre;5204;2646;2558
07137;      Mayen-Koblenz, Landkreis;6 bis unter 10 Jahre;7442;3797;3645
07137;      Mayen-Koblenz, Landkreis;10 bis unter 15 Jahre;10774;5432;5342
07137;      Mayen-Koblenz, Landkreis;15 bis unter 18 Jahre;6893;3609;3284
07137;      Mayen-Koblenz, Landkreis;18 bis unter 20 Jahre;4856;2586;2270
07137;      Mayen-Koblenz, Landkreis;20 bis unter 25 Jahre;11814;6184;5630
07137;      Mayen-Koblenz, Landkreis;25 bis unter 30 Jahre;11052;5573;5479
07137;      Mayen-Koblenz, Landkreis;30 bis unter 35 Jahre;11453;5670;5783
07137;      Mayen-Koblenz, Landkreis;35 bis unter 40 Jahre;11460;5662;5798
07137;      Mayen-Koblenz, Landkreis;40 bis unter 45 Jahre;16198;8141;8057
07137;      Mayen-Koblenz, Landkreis;45 bis unter 50 Jahre;18652;9397;9255
07137;      Mayen-Koblenz, Landkreis;50 bis unter 55 Jahre;17250;8655;8595
07137;      Mayen-Koblenz, Landkreis;55 bis unter 60 Jahre;15592;7733;7859
07137;      Mayen-Koblenz, Landkreis;60 bis unter 65 Jahre;13122;6640;6482
07137;      Mayen-Koblenz, Landkreis;65 bis unter 75 Jahre;22455;10791;11664
07137;      Mayen-Koblenz, Landkreis;75 Jahre und mehr;20606;7996;12610
07137;      Mayen-Koblenz, Landkreis;Insgesamt;209718;103017;106701
07138;      Neuwied, Landkreis;unter 3 Jahre;4254;2136;2118
07138;      Neuwied, Landkreis;3 bis unter 6 Jahre;4519;2344;2175
07138;      Neuwied, Landkreis;6 bis unter 10 Jahre;6619;3407;3212
07138;      Neuwied, Landkreis;10 bis unter 15 Jahre;9839;5033;4806
07138;      Neuwied, Landkreis;15 bis unter 18 Jahre;6209;3203;3006
07138;      Neuwied, Landkreis;18 bis unter 20 Jahre;4324;2261;2063
07138;      Neuwied, Landkreis;20 bis unter 25 Jahre;10501;5595;4906
07138;      Neuwied, Landkreis;25 bis unter 30 Jahre;8968;4574;4394
07138;      Neuwied, Landkreis;30 bis unter 35 Jahre;9084;4417;4667
07138;      Neuwied, Landkreis;35 bis unter 40 Jahre;9469;4650;4819
07138;      Neuwied, Landkreis;40 bis unter 45 Jahre;13653;6854;6799
07138;      Neuwied, Landkreis;45 bis unter 50 Jahre;15524;7809;7715
07138;      Neuwied, Landkreis;50 bis unter 55 Jahre;14899;7444;7455
07138;      Neuwied, Landkreis;55 bis unter 60 Jahre;12833;6346;6487
07138;      Neuwied, Landkreis;60 bis unter 65 Jahre;11200;5637;5563
07138;      Neuwied, Landkreis;65 bis unter 75 Jahre;19549;9205;10344
07138;      Neuwied, Landkreis;75 Jahre und mehr;19094;7556;11538
07138;      Neuwied, Landkreis;Insgesamt;180538;88471;92067
07140;      Rhein-Hunsrück-Kreis;unter 3 Jahre;2237;1152;1085
07140;      Rhein-Hunsrück-Kreis;3 bis unter 6 Jahre;2391;1258;1133
07140;      Rhein-Hunsrück-Kreis;6 bis unter 10 Jahre;3612;1834;1778
07140;      Rhein-Hunsrück-Kreis;10 bis unter 15 Jahre;5422;2795;2627
07140;      Rhein-Hunsrück-Kreis;15 bis unter 18 Jahre;3425;1762;1663
07140;      Rhein-Hunsrück-Kreis;18 bis unter 20 Jahre;2493;1214;1279
07140;      Rhein-Hunsrück-Kreis;20 bis unter 25 Jahre;5470;2923;2547
07140;      Rhein-Hunsrück-Kreis;25 bis unter 30 Jahre;5288;2736;2552
07140;      Rhein-Hunsrück-Kreis;30 bis unter 35 Jahre;5277;2595;2682
07140;      Rhein-Hunsrück-Kreis;35 bis unter 40 Jahre;5500;2763;2737
07140;      Rhein-Hunsrück-Kreis;40 bis unter 45 Jahre;7696;3825;3871
07140;      Rhein-Hunsrück-Kreis;45 bis unter 50 Jahre;8837;4502;4335
07140;      Rhein-Hunsrück-Kreis;50 bis unter 55 Jahre;8326;4189;4137
07140;      Rhein-Hunsrück-Kreis;55 bis unter 60 Jahre;7511;3831;3680
07140;      Rhein-Hunsrück-Kreis;60 bis unter 65 Jahre;6467;3296;3171
07140;      Rhein-Hunsrück-Kreis;65 bis unter 75 Jahre;10621;5079;5542
07140;      Rhein-Hunsrück-Kreis;75 Jahre und mehr;10584;4172;6412
07140;      Rhein-Hunsrück-Kreis;Insgesamt;101157;49926;51231
07141;      Rhein-Lahn-Kreis;unter 3 Jahre;2634;1410;1224
07141;      Rhein-Lahn-Kreis;3 bis unter 6 Jahre;2948;1495;1453
07141;      Rhein-Lahn-Kreis;6 bis unter 10 Jahre;4085;2105;1980
07141;      Rhein-Lahn-Kreis;10 bis unter 15 Jahre;6150;3172;2978
07141;      Rhein-Lahn-Kreis;15 bis unter 18 Jahre;3968;2062;1906
07141;      Rhein-Lahn-Kreis;18 bis unter 20 Jahre;2737;1382;1355
07141;      Rhein-Lahn-Kreis;20 bis unter 25 Jahre;6687;3499;3188
07141;      Rhein-Lahn-Kreis;25 bis unter 30 Jahre;6117;3205;2912
07141;      Rhein-Lahn-Kreis;30 bis unter 35 Jahre;6378;3192;3186
07141;      Rhein-Lahn-Kreis;35 bis unter 40 Jahre;6516;3321;3195
07141;      Rhein-Lahn-Kreis;40 bis unter 45 Jahre;9106;4546;4560
07141;      Rhein-Lahn-Kreis;45 bis unter 50 Jahre;10686;5391;5295
07141;      Rhein-Lahn-Kreis;50 bis unter 55 Jahre;10176;5128;5048
07141;      Rhein-Lahn-Kreis;55 bis unter 60 Jahre;8868;4400;4468
07141;      Rhein-Lahn-Kreis;60 bis unter 65 Jahre;8303;4201;4102
07141;      Rhein-Lahn-Kreis;65 bis unter 75 Jahre;14061;6825;7236
07141;      Rhein-Lahn-Kreis;75 Jahre und mehr;13195;5136;8059
07141;      Rhein-Lahn-Kreis;Insgesamt;122615;60470;62145
07143;      Westerwaldkreis;unter 3 Jahre;4743;2441;2302
07143;      Westerwaldkreis;3 bis unter 6 Jahre;5148;2599;2549
07143;      Westerwaldkreis;6 bis unter 10 Jahre;7563;3911;3652
07143;      Westerwaldkreis;10 bis unter 15 Jahre;10857;5527;5330
07143;      Westerwaldkreis;15 bis unter 18 Jahre;6903;3527;3376
07143;      Westerwaldkreis;18 bis unter 20 Jahre;4818;2552;2266
07143;      Westerwaldkreis;20 bis unter 25 Jahre;11576;6124;5452
07143;      Westerwaldkreis;25 bis unter 30 Jahre;10439;5404;5035
07143;      Westerwaldkreis;30 bis unter 35 Jahre;10692;5282;5410
07143;      Westerwaldkreis;35 bis unter 40 Jahre;11257;5655;5602
07143;      Westerwaldkreis;40 bis unter 45 Jahre;15512;7827;7685
07143;      Westerwaldkreis;45 bis unter 50 Jahre;17595;9031;8564
07143;      Westerwaldkreis;50 bis unter 55 Jahre;15901;8053;7848
07143;      Westerwaldkreis;55 bis unter 60 Jahre;13560;6861;6699
07143;      Westerwaldkreis;60 bis unter 65 Jahre;11982;6025;5957
07143;      Westerwaldkreis;65 bis unter 75 Jahre;20228;9741;10487
07143;      Westerwaldkreis;75 Jahre und mehr;18957;7465;11492
07143;      Westerwaldkreis;Insgesamt;197731;98025;99706
072;    Trier, Stat. Region;unter 3 Jahre;12374;6352;6022
072;    Trier, Stat. Region;3 bis unter 6 Jahre;12554;6531;6023
072;    Trier, Stat. Region;6 bis unter 10 Jahre;17626;8962;8664
072;    Trier, Stat. Region;10 bis unter 15 Jahre;25667;13126;12541
072;    Trier, Stat. Region;15 bis unter 18 Jahre;16582;8434;8148
072;    Trier, Stat. Region;18 bis unter 20 Jahre;12245;6189;6056
072;    Trier, Stat. Region;20 bis unter 25 Jahre;34009;16962;17047
072;    Trier, Stat. Region;25 bis unter 30 Jahre;31147;15892;15255
072;    Trier, Stat. Region;30 bis unter 35 Jahre;29463;14832;14631
072;    Trier, Stat. Region;35 bis unter 40 Jahre;29184;14632;14552
072;    Trier, Stat. Region;40 bis unter 45 Jahre;38904;19738;19166
072;    Trier, Stat. Region;45 bis unter 50 Jahre;44346;22569;21777
072;    Trier, Stat. Region;50 bis unter 55 Jahre;40233;20473;19760
072;    Trier, Stat. Region;55 bis unter 60 Jahre;36027;18250;17777
072;    Trier, Stat. Region;60 bis unter 65 Jahre;30168;15295;14873
072;    Trier, Stat. Region;65 bis unter 75 Jahre;50646;24062;26584
072;    Trier, Stat. Region;75 Jahre und mehr;51813;19795;32018
072;    Trier, Stat. Region;Insgesamt;512988;252094;260894
07211;      Trier, Kreisfreie Stadt;unter 3 Jahre;2614;1348;1266
07211;      Trier, Kreisfreie Stadt;3 bis unter 6 Jahre;2392;1259;1133
07211;      Trier, Kreisfreie Stadt;6 bis unter 10 Jahre;3179;1646;1533
07211;      Trier, Kreisfreie Stadt;10 bis unter 15 Jahre;4085;2069;2016
07211;      Trier, Kreisfreie Stadt;15 bis unter 18 Jahre;2523;1278;1245
07211;      Trier, Kreisfreie Stadt;18 bis unter 20 Jahre;2341;1089;1252
07211;      Trier, Kreisfreie Stadt;20 bis unter 25 Jahre;11209;4978;6231
07211;      Trier, Kreisfreie Stadt;25 bis unter 30 Jahre;9789;4825;4964
07211;      Trier, Kreisfreie Stadt;30 bis unter 35 Jahre;7423;3883;3540
07211;      Trier, Kreisfreie Stadt;35 bis unter 40 Jahre;6058;3121;2937
07211;      Trier, Kreisfreie Stadt;40 bis unter 45 Jahre;7763;3821;3942
07211;      Trier, Kreisfreie Stadt;45 bis unter 50 Jahre;8710;4232;4478
07211;      Trier, Kreisfreie Stadt;50 bis unter 55 Jahre;7280;3638;3642
07211;      Trier, Kreisfreie Stadt;55 bis unter 60 Jahre;6238;3054;3184
07211;      Trier, Kreisfreie Stadt;60 bis unter 65 Jahre;5222;2501;2721
07211;      Trier, Kreisfreie Stadt;65 bis unter 75 Jahre;9139;4041;5098
07211;      Trier, Kreisfreie Stadt;75 Jahre und mehr;9710;3472;6238
07211;      Trier, Kreisfreie Stadt;Insgesamt;105675;50255;55420
07231;      Bernkastel-Wittlich, Landkreis;unter 3 Jahre;2585;1343;1242
07231;      Bernkastel-Wittlich, Landkreis;3 bis unter 6 Jahre;2673;1346;1327
07231;      Bernkastel-Wittlich, Landkreis;6 bis unter 10 Jahre;3829;1936;1893
07231;      Bernkastel-Wittlich, Landkreis;10 bis unter 15 Jahre;5694;2890;2804
07231;      Bernkastel-Wittlich, Landkreis;15 bis unter 18 Jahre;3689;1889;1800
07231;      Bernkastel-Wittlich, Landkreis;18 bis unter 20 Jahre;2632;1338;1294
07231;      Bernkastel-Wittlich, Landkreis;20 bis unter 25 Jahre;6169;3285;2884
07231;      Bernkastel-Wittlich, Landkreis;25 bis unter 30 Jahre;5655;2918;2737
07231;      Bernkastel-Wittlich, Landkreis;30 bis unter 35 Jahre;5992;2999;2993
07231;      Bernkastel-Wittlich, Landkreis;35 bis unter 40 Jahre;6151;3107;3044
07231;      Bernkastel-Wittlich, Landkreis;40 bis unter 45 Jahre;8135;4222;3913
07231;      Bernkastel-Wittlich, Landkreis;45 bis unter 50 Jahre;9406;4818;4588
07231;      Bernkastel-Wittlich, Landkreis;50 bis unter 55 Jahre;8783;4449;4334
07231;      Bernkastel-Wittlich, Landkreis;55 bis unter 60 Jahre;8134;4103;4031
07231;      Bernkastel-Wittlich, Landkreis;60 bis unter 65 Jahre;6964;3579;3385
07231;      Bernkastel-Wittlich, Landkreis;65 bis unter 75 Jahre;11557;5599;5958
07231;      Bernkastel-Wittlich, Landkreis;75 Jahre und mehr;11870;4579;7291
07231;      Bernkastel-Wittlich, Landkreis;Insgesamt;109918;54400;55518
07232;      Eifelkreis Bitburg-Prüm;unter 3 Jahre;2293;1199;1094
07232;      Eifelkreis Bitburg-Prüm;3 bis unter 6 Jahre;2353;1238;1115
07232;      Eifelkreis Bitburg-Prüm;6 bis unter 10 Jahre;3425;1754;1671
07232;      Eifelkreis Bitburg-Prüm;10 bis unter 15 Jahre;5000;2606;2394
07232;      Eifelkreis Bitburg-Prüm;15 bis unter 18 Jahre;3284;1655;1629
07232;      Eifelkreis Bitburg-Prüm;18 bis unter 20 Jahre;2392;1207;1185
07232;      Eifelkreis Bitburg-Prüm;20 bis unter 25 Jahre;5333;2783;2550
07232;      Eifelkreis Bitburg-Prüm;25 bis unter 30 Jahre;5209;2682;2527
07232;      Eifelkreis Bitburg-Prüm;30 bis unter 35 Jahre;5019;2590;2429
07232;      Eifelkreis Bitburg-Prüm;35 bis unter 40 Jahre;5309;2676;2633
07232;      Eifelkreis Bitburg-Prüm;40 bis unter 45 Jahre;7154;3701;3453
07232;      Eifelkreis Bitburg-Prüm;45 bis unter 50 Jahre;8297;4310;3987
07232;      Eifelkreis Bitburg-Prüm;50 bis unter 55 Jahre;7578;3910;3668
07232;      Eifelkreis Bitburg-Prüm;55 bis unter 60 Jahre;6742;3509;3233
07232;      Eifelkreis Bitburg-Prüm;60 bis unter 65 Jahre;5605;2888;2717
07232;      Eifelkreis Bitburg-Prüm;65 bis unter 75 Jahre;9117;4397;4720
07232;      Eifelkreis Bitburg-Prüm;75 Jahre und mehr;9697;3729;5968
07232;      Eifelkreis Bitburg-Prüm;Insgesamt;93807;46834;46973
07233;      Vulkaneifel, Landkreis;unter 3 Jahre;1281;665;616
07233;      Vulkaneifel, Landkreis;3 bis unter 6 Jahre;1407;729;678
07233;      Vulkaneifel, Landkreis;6 bis unter 10 Jahre;2101;1065;1036
07233;      Vulkaneifel, Landkreis;10 bis unter 15 Jahre;3324;1684;1640
07233;      Vulkaneifel, Landkreis;15 bis unter 18 Jahre;2145;1091;1054
07233;      Vulkaneifel, Landkreis;18 bis unter 20 Jahre;1563;817;746
07233;      Vulkaneifel, Landkreis;20 bis unter 25 Jahre;3457;1884;1573
07233;      Vulkaneifel, Landkreis;25 bis unter 30 Jahre;2968;1576;1392
07233;      Vulkaneifel, Landkreis;30 bis unter 35 Jahre;2969;1457;1512
07233;      Vulkaneifel, Landkreis;35 bis unter 40 Jahre;3168;1571;1597
07233;      Vulkaneifel, Landkreis;40 bis unter 45 Jahre;4104;2007;2097
07233;      Vulkaneifel, Landkreis;45 bis unter 50 Jahre;5045;2585;2460
07233;      Vulkaneifel, Landkreis;50 bis unter 55 Jahre;4899;2532;2367
07233;      Vulkaneifel, Landkreis;55 bis unter 60 Jahre;4426;2267;2159
07233;      Vulkaneifel, Landkreis;60 bis unter 65 Jahre;3876;1976;1900
07233;      Vulkaneifel, Landkreis;65 bis unter 75 Jahre;6926;3346;3580
07233;      Vulkaneifel, Landkreis;75 Jahre und mehr;6989;2830;4159
07233;      Vulkaneifel, Landkreis;Insgesamt;60648;30082;30566
07235;      Trier-Saarburg, Landkreis;unter 3 Jahre;3601;1797;1804
07235;      Trier-Saarburg, Landkreis;3 bis unter 6 Jahre;3729;1959;1770
07235;      Trier-Saarburg, Landkreis;6 bis unter 10 Jahre;5092;2561;2531
07235;      Trier-Saarburg, Landkreis;10 bis unter 15 Jahre;7564;3877;3687
07235;      Trier-Saarburg, Landkreis;15 bis unter 18 Jahre;4941;2521;2420
07235;      Trier-Saarburg, Landkreis;18 bis unter 20 Jahre;3317;1738;1579
07235;      Trier-Saarburg, Landkreis;20 bis unter 25 Jahre;7841;4032;3809
07235;      Trier-Saarburg, Landkreis;25 bis unter 30 Jahre;7526;3891;3635
07235;      Trier-Saarburg, Landkreis;30 bis unter 35 Jahre;8060;3903;4157
07235;      Trier-Saarburg, Landkreis;35 bis unter 40 Jahre;8498;4157;4341
07235;      Trier-Saarburg, Landkreis;40 bis unter 45 Jahre;11748;5987;5761
07235;      Trier-Saarburg, Landkreis;45 bis unter 50 Jahre;12888;6624;6264
07235;      Trier-Saarburg, Landkreis;50 bis unter 55 Jahre;11693;5944;5749
07235;      Trier-Saarburg, Landkreis;55 bis unter 60 Jahre;10487;5317;5170
07235;      Trier-Saarburg, Landkreis;60 bis unter 65 Jahre;8501;4351;4150
07235;      Trier-Saarburg, Landkreis;65 bis unter 75 Jahre;13907;6679;7228
07235;      Trier-Saarburg, Landkreis;75 Jahre und mehr;13547;5185;8362
07235;      Trier-Saarburg, Landkreis;Insgesamt;142940;70523;72417
073;    Rheinhessen-Pfalz, Stat. Region;unter 3 Jahre;48327;24847;23480
073;    Rheinhessen-Pfalz, Stat. Region;3 bis unter 6 Jahre;49769;25670;24099
073;    Rheinhessen-Pfalz, Stat. Region;6 bis unter 10 Jahre;68859;35588;33271
073;    Rheinhessen-Pfalz, Stat. Region;10 bis unter 15 Jahre;98239;50294;47945
073;    Rheinhessen-Pfalz, Stat. Region;15 bis unter 18 Jahre;61998;31808;30190
073;    Rheinhessen-Pfalz, Stat. Region;18 bis unter 20 Jahre;44659;22835;21824
073;    Rheinhessen-Pfalz, Stat. Region;20 bis unter 25 Jahre;125396;63276;62120
073;    Rheinhessen-Pfalz, Stat. Region;25 bis unter 30 Jahre;118813;59970;58843
073;    Rheinhessen-Pfalz, Stat. Region;30 bis unter 35 Jahre;114518;57173;57345
073;    Rheinhessen-Pfalz, Stat. Region;35 bis unter 40 Jahre;113698;56649;57049
073;    Rheinhessen-Pfalz, Stat. Region;40 bis unter 45 Jahre;154988;78596;76392
073;    Rheinhessen-Pfalz, Stat. Region;45 bis unter 50 Jahre;176623;90494;86129
073;    Rheinhessen-Pfalz, Stat. Region;50 bis unter 55 Jahre;164875;83251;81624
073;    Rheinhessen-Pfalz, Stat. Region;55 bis unter 60 Jahre;141287;70867;70420
073;    Rheinhessen-Pfalz, Stat. Region;60 bis unter 65 Jahre;122599;60800;61799
073;    Rheinhessen-Pfalz, Stat. Region;65 bis unter 75 Jahre;210721;100573;110148
073;    Rheinhessen-Pfalz, Stat. Region;75 Jahre und mehr;193471;75748;117723
073;    Rheinhessen-Pfalz, Stat. Region;Insgesamt;2008840;988439;1020401
07311;      Frankenthal (Pfalz), Kreisfreie Stadt;unter 3 Jahre;1174;604;570
07311;      Frankenthal (Pfalz), Kreisfreie Stadt;3 bis unter 6 Jahre;1132;593;539
07311;      Frankenthal (Pfalz), Kreisfreie Stadt;6 bis unter 10 Jahre;1562;797;765
07311;      Frankenthal (Pfalz), Kreisfreie Stadt;10 bis unter 15 Jahre;2200;1147;1053
07311;      Frankenthal (Pfalz), Kreisfreie Stadt;15 bis unter 18 Jahre;1398;673;725
07311;      Frankenthal (Pfalz), Kreisfreie Stadt;18 bis unter 20 Jahre;1010;530;480
07311;      Frankenthal (Pfalz), Kreisfreie Stadt;20 bis unter 25 Jahre;2732;1417;1315
07311;      Frankenthal (Pfalz), Kreisfreie Stadt;25 bis unter 30 Jahre;2705;1339;1366
07311;      Frankenthal (Pfalz), Kreisfreie Stadt;30 bis unter 35 Jahre;2804;1442;1362
07311;      Frankenthal (Pfalz), Kreisfreie Stadt;35 bis unter 40 Jahre;2631;1387;1244
07311;      Frankenthal (Pfalz), Kreisfreie Stadt;40 bis unter 45 Jahre;3533;1827;1706
07311;      Frankenthal (Pfalz), Kreisfreie Stadt;45 bis unter 50 Jahre;3650;1914;1736
07311;      Frankenthal (Pfalz), Kreisfreie Stadt;50 bis unter 55 Jahre;3740;1912;1828
07311;      Frankenthal (Pfalz), Kreisfreie Stadt;55 bis unter 60 Jahre;3180;1568;1612
07311;      Frankenthal (Pfalz), Kreisfreie Stadt;60 bis unter 65 Jahre;2808;1370;1438
07311;      Frankenthal (Pfalz), Kreisfreie Stadt;65 bis unter 75 Jahre;5543;2542;3001
07311;      Frankenthal (Pfalz), Kreisfreie Stadt;75 Jahre und mehr;5200;2012;3188
07311;      Frankenthal (Pfalz), Kreisfreie Stadt;Insgesamt;47002;23074;23928
07312;      Kaiserslautern, Kreisfreie Stadt;unter 3 Jahre;2393;1197;1196
07312;      Kaiserslautern, Kreisfreie Stadt;3 bis unter 6 Jahre;2296;1204;1092
07312;      Kaiserslautern, Kreisfreie Stadt;6 bis unter 10 Jahre;2925;1529;1396
07312;      Kaiserslautern, Kreisfreie Stadt;10 bis unter 15 Jahre;4046;2105;1941
07312;      Kaiserslautern, Kreisfreie Stadt;15 bis unter 18 Jahre;2607;1356;1251
07312;      Kaiserslautern, Kreisfreie Stadt;18 bis unter 20 Jahre;2252;1151;1101
07312;      Kaiserslautern, Kreisfreie Stadt;20 bis unter 25 Jahre;9104;5179;3925
07312;      Kaiserslautern, Kreisfreie Stadt;25 bis unter 30 Jahre;7966;4372;3594
07312;      Kaiserslautern, Kreisfreie Stadt;30 bis unter 35 Jahre;6244;3328;2916
07312;      Kaiserslautern, Kreisfreie Stadt;35 bis unter 40 Jahre;5325;2750;2575
07312;      Kaiserslautern, Kreisfreie Stadt;40 bis unter 45 Jahre;6947;3681;3266
07312;      Kaiserslautern, Kreisfreie Stadt;45 bis unter 50 Jahre;8397;4618;3779
07312;      Kaiserslautern, Kreisfreie Stadt;50 bis unter 55 Jahre;7581;3910;3671
07312;      Kaiserslautern, Kreisfreie Stadt;55 bis unter 60 Jahre;6514;3231;3283
07312;      Kaiserslautern, Kreisfreie Stadt;60 bis unter 65 Jahre;5532;2653;2879
07312;      Kaiserslautern, Kreisfreie Stadt;65 bis unter 75 Jahre;10241;4733;5508
07312;      Kaiserslautern, Kreisfreie Stadt;75 Jahre und mehr;9420;3644;5776
07312;      Kaiserslautern, Kreisfreie Stadt;Insgesamt;99790;50641;49149
07313;      Landau in der Pfalz, Kreisfreie Stadt;unter 3 Jahre;1087;570;517
07313;      Landau in der Pfalz, Kreisfreie Stadt;3 bis unter 6 Jahre;1058;548;510
07313;      Landau in der Pfalz, Kreisfreie Stadt;6 bis unter 10 Jahre;1419;706;713
07313;      Landau in der Pfalz, Kreisfreie Stadt;10 bis unter 15 Jahre;2062;1068;994
07313;      Landau in der Pfalz, Kreisfreie Stadt;15 bis unter 18 Jahre;1205;626;579
07313;      Landau in der Pfalz, Kreisfreie Stadt;18 bis unter 20 Jahre;1017;498;519
07313;      Landau in der Pfalz, Kreisfreie Stadt;20 bis unter 25 Jahre;3709;1517;2192
07313;      Landau in der Pfalz, Kreisfreie Stadt;25 bis unter 30 Jahre;3034;1475;1559
07313;      Landau in der Pfalz, Kreisfreie Stadt;30 bis unter 35 Jahre;2600;1285;1315
07313;      Landau in der Pfalz, Kreisfreie Stadt;35 bis unter 40 Jahre;2517;1242;1275
07313;      Landau in der Pfalz, Kreisfreie Stadt;40 bis unter 45 Jahre;3517;1750;1767
07313;      Landau in der Pfalz, Kreisfreie Stadt;45 bis unter 50 Jahre;3893;1884;2009
07313;      Landau in der Pfalz, Kreisfreie Stadt;50 bis unter 55 Jahre;3363;1670;1693
07313;      Landau in der Pfalz, Kreisfreie Stadt;55 bis unter 60 Jahre;2805;1410;1395
07313;      Landau in der Pfalz, Kreisfreie Stadt;60 bis unter 65 Jahre;2397;1170;1227
07313;      Landau in der Pfalz, Kreisfreie Stadt;65 bis unter 75 Jahre;4271;1961;2310
07313;      Landau in der Pfalz, Kreisfreie Stadt;75 Jahre und mehr;4003;1422;2581
07313;      Landau in der Pfalz, Kreisfreie Stadt;Insgesamt;43957;20802;23155
07314;      Ludwigshafen am Rhein, Kreisfreie Stadt;unter 3 Jahre;4717;2401;2316
07314;      Ludwigshafen am Rhein, Kreisfreie Stadt;3 bis unter 6 Jahre;4550;2349;2201
07314;      Ludwigshafen am Rhein, Kreisfreie Stadt;6 bis unter 10 Jahre;5922;3121;2801
07314;      Ludwigshafen am Rhein, Kreisfreie Stadt;10 bis unter 15 Jahre;7657;3819;3838
07314;      Ludwigshafen am Rhein, Kreisfreie Stadt;15 bis unter 18 Jahre;4743;2429;2314
07314;      Ludwigshafen am Rhein, Kreisfreie Stadt;18 bis unter 20 Jahre;3550;1824;1726
07314;      Ludwigshafen am Rhein, Kreisfreie Stadt;20 bis unter 25 Jahre;10663;5354;5309
07314;      Ludwigshafen am Rhein, Kreisfreie Stadt;25 bis unter 30 Jahre;10762;5307;5455
07314;      Ludwigshafen am Rhein, Kreisfreie Stadt;30 bis unter 35 Jahre;10508;5387;5121
07314;      Ludwigshafen am Rhein, Kreisfreie Stadt;35 bis unter 40 Jahre;10254;5383;4871
07314;      Ludwigshafen am Rhein, Kreisfreie Stadt;40 bis unter 45 Jahre;12847;6823;6024
07314;      Ludwigshafen am Rhein, Kreisfreie Stadt;45 bis unter 50 Jahre;14206;7581;6625
07314;      Ludwigshafen am Rhein, Kreisfreie Stadt;50 bis unter 55 Jahre;12604;6618;5986
07314;      Ludwigshafen am Rhein, Kreisfreie Stadt;55 bis unter 60 Jahre;10447;5274;5173
07314;      Ludwigshafen am Rhein, Kreisfreie Stadt;60 bis unter 65 Jahre;9248;4530;4718
07314;      Ludwigshafen am Rhein, Kreisfreie Stadt;65 bis unter 75 Jahre;17061;8209;8852
07314;      Ludwigshafen am Rhein, Kreisfreie Stadt;75 Jahre und mehr;15821;6325;9496
07314;      Ludwigshafen am Rhein, Kreisfreie Stadt;Insgesamt;165560;82734;82826
07315;      Mainz, Kreisfreie Stadt;unter 3 Jahre;5345;2801;2544
07315;      Mainz, Kreisfreie Stadt;3 bis unter 6 Jahre;5019;2594;2425
07315;      Mainz, Kreisfreie Stadt;6 bis unter 10 Jahre;6309;3269;3040
07315;      Mainz, Kreisfreie Stadt;10 bis unter 15 Jahre;7775;4012;3763
07315;      Mainz, Kreisfreie Stadt;15 bis unter 18 Jahre;4862;2477;2385
07315;      Mainz, Kreisfreie Stadt;18 bis unter 20 Jahre;3777;1803;1974
07315;      Mainz, Kreisfreie Stadt;20 bis unter 25 Jahre;18215;7765;10450
07315;      Mainz, Kreisfreie Stadt;25 bis unter 30 Jahre;19464;9261;10203
07315;      Mainz, Kreisfreie Stadt;30 bis unter 35 Jahre;15758;7939;7819
07315;      Mainz, Kreisfreie Stadt;35 bis unter 40 Jahre;13028;6629;6399
07315;      Mainz, Kreisfreie Stadt;40 bis unter 45 Jahre;14974;7806;7168
07315;      Mainz, Kreisfreie Stadt;45 bis unter 50 Jahre;15850;8162;7688
07315;      Mainz, Kreisfreie Stadt;50 bis unter 55 Jahre;13715;6894;6821
07315;      Mainz, Kreisfreie Stadt;55 bis unter 60 Jahre;11495;5562;5933
07315;      Mainz, Kreisfreie Stadt;60 bis unter 65 Jahre;10116;4913;5203
07315;      Mainz, Kreisfreie Stadt;65 bis unter 75 Jahre;18659;8746;9913
07315;      Mainz, Kreisfreie Stadt;75 Jahre und mehr;16596;6296;10300
07315;      Mainz, Kreisfreie Stadt;Insgesamt;200957;96929;104028
07316;      Neustadt an der Weinstraße, Kreisfreie Stadt;unter 3 Jahre;1261;649;612
07316;      Neustadt an der Weinstraße, Kreisfreie Stadt;3 bis unter 6 Jahre;1284;668;616
07316;      Neustadt an der Weinstraße, Kreisfreie Stadt;6 bis unter 10 Jahre;1836;937;899
07316;      Neustadt an der Weinstraße, Kreisfreie Stadt;10 bis unter 15 Jahre;2418;1210;1208
07316;      Neustadt an der Weinstraße, Kreisfreie Stadt;15 bis unter 18 Jahre;1585;829;756
07316;      Neustadt an der Weinstraße, Kreisfreie Stadt;18 bis unter 20 Jahre;1125;545;580
07316;      Neustadt an der Weinstraße, Kreisfreie Stadt;20 bis unter 25 Jahre;2992;1495;1497
07316;      Neustadt an der Weinstraße, Kreisfreie Stadt;25 bis unter 30 Jahre;2895;1450;1445
07316;      Neustadt an der Weinstraße, Kreisfreie Stadt;30 bis unter 35 Jahre;2690;1347;1343
07316;      Neustadt an der Weinstraße, Kreisfreie Stadt;35 bis unter 40 Jahre;2596;1283;1313
07316;      Neustadt an der Weinstraße, Kreisfreie Stadt;40 bis unter 45 Jahre;3875;1897;1978
07316;      Neustadt an der Weinstraße, Kreisfreie Stadt;45 bis unter 50 Jahre;4502;2279;2223
07316;      Neustadt an der Weinstraße, Kreisfreie Stadt;50 bis unter 55 Jahre;4473;2197;2276
07316;      Neustadt an der Weinstraße, Kreisfreie Stadt;55 bis unter 60 Jahre;3805;1905;1900
07316;      Neustadt an der Weinstraße, Kreisfreie Stadt;60 bis unter 65 Jahre;3291;1566;1725
07316;      Neustadt an der Weinstraße, Kreisfreie Stadt;65 bis unter 75 Jahre;6088;2806;3282
07316;      Neustadt an der Weinstraße, Kreisfreie Stadt;75 Jahre und mehr;6225;2365;3860
07316;      Neustadt an der Weinstraße, Kreisfreie Stadt;Insgesamt;52941;25428;27513
07317;      Pirmasens, Kreisfreie Stadt;unter 3 Jahre;911;462;449
07317;      Pirmasens, Kreisfreie Stadt;3 bis unter 6 Jahre;929;508;421
07317;      Pirmasens, Kreisfreie Stadt;6 bis unter 10 Jahre;1184;613;571
07317;      Pirmasens, Kreisfreie Stadt;10 bis unter 15 Jahre;1768;906;862
07317;      Pirmasens, Kreisfreie Stadt;15 bis unter 18 Jahre;1159;591;568
07317;      Pirmasens, Kreisfreie Stadt;18 bis unter 20 Jahre;881;444;437
07317;      Pirmasens, Kreisfreie Stadt;20 bis unter 25 Jahre;2336;1202;1134
07317;      Pirmasens, Kreisfreie Stadt;25 bis unter 30 Jahre;2171;1143;1028
07317;      Pirmasens, Kreisfreie Stadt;30 bis unter 35 Jahre;2031;1072;959
07317;      Pirmasens, Kreisfreie Stadt;35 bis unter 40 Jahre;1948;1012;936
07317;      Pirmasens, Kreisfreie Stadt;40 bis unter 45 Jahre;2728;1403;1325
07317;      Pirmasens, Kreisfreie Stadt;45 bis unter 50 Jahre;3246;1644;1602
07317;      Pirmasens, Kreisfreie Stadt;50 bis unter 55 Jahre;3260;1675;1585
07317;      Pirmasens, Kreisfreie Stadt;55 bis unter 60 Jahre;2948;1497;1451
07317;      Pirmasens, Kreisfreie Stadt;60 bis unter 65 Jahre;2578;1260;1318
07317;      Pirmasens, Kreisfreie Stadt;65 bis unter 75 Jahre;4779;2181;2598
07317;      Pirmasens, Kreisfreie Stadt;75 Jahre und mehr;5149;1903;3246
07317;      Pirmasens, Kreisfreie Stadt;Insgesamt;40006;19516;20490
07318;      Speyer, Kreisfreie Stadt;unter 3 Jahre;1335;685;650
07318;      Speyer, Kreisfreie Stadt;3 bis unter 6 Jahre;1263;656;607
07318;      Speyer, Kreisfreie Stadt;6 bis unter 10 Jahre;1799;912;887
07318;      Speyer, Kreisfreie Stadt;10 bis unter 15 Jahre;2416;1217;1199
07318;      Speyer, Kreisfreie Stadt;15 bis unter 18 Jahre;1508;777;731
07318;      Speyer, Kreisfreie Stadt;18 bis unter 20 Jahre;1035;515;520
07318;      Speyer, Kreisfreie Stadt;20 bis unter 25 Jahre;2741;1373;1368
07318;      Speyer, Kreisfreie Stadt;25 bis unter 30 Jahre;2803;1445;1358
07318;      Speyer, Kreisfreie Stadt;30 bis unter 35 Jahre;2939;1403;1536
07318;      Speyer, Kreisfreie Stadt;35 bis unter 40 Jahre;2931;1464;1467
07318;      Speyer, Kreisfreie Stadt;40 bis unter 45 Jahre;3957;1982;1975
07318;      Speyer, Kreisfreie Stadt;45 bis unter 50 Jahre;4407;2213;2194
07318;      Speyer, Kreisfreie Stadt;50 bis unter 55 Jahre;4158;2070;2088
07318;      Speyer, Kreisfreie Stadt;55 bis unter 60 Jahre;3522;1737;1785
07318;      Speyer, Kreisfreie Stadt;60 bis unter 65 Jahre;3112;1445;1667
07318;      Speyer, Kreisfreie Stadt;65 bis unter 75 Jahre;5302;2427;2875
07318;      Speyer, Kreisfreie Stadt;75 Jahre und mehr;4808;1764;3044
07318;      Speyer, Kreisfreie Stadt;Insgesamt;50036;24085;25951
07319;      Worms, Kreisfreie Stadt;unter 3 Jahre;2084;1090;994
07319;      Worms, Kreisfreie Stadt;3 bis unter 6 Jahre;2201;1106;1095
07319;      Worms, Kreisfreie Stadt;6 bis unter 10 Jahre;2931;1512;1419
07319;      Worms, Kreisfreie Stadt;10 bis unter 15 Jahre;3859;1974;1885
07319;      Worms, Kreisfreie Stadt;15 bis unter 18 Jahre;2406;1210;1196
07319;      Worms, Kreisfreie Stadt;18 bis unter 20 Jahre;1864;922;942
07319;      Worms, Kreisfreie Stadt;20 bis unter 25 Jahre;5515;2701;2814
07319;      Worms, Kreisfreie Stadt;25 bis unter 30 Jahre;5292;2644;2648
07319;      Worms, Kreisfreie Stadt;30 bis unter 35 Jahre;5062;2512;2550
07319;      Worms, Kreisfreie Stadt;35 bis unter 40 Jahre;5003;2525;2478
07319;      Worms, Kreisfreie Stadt;40 bis unter 45 Jahre;6138;3225;2913
07319;      Worms, Kreisfreie Stadt;45 bis unter 50 Jahre;6799;3560;3239
07319;      Worms, Kreisfreie Stadt;50 bis unter 55 Jahre;6544;3319;3225
07319;      Worms, Kreisfreie Stadt;55 bis unter 60 Jahre;5539;2709;2830
07319;      Worms, Kreisfreie Stadt;60 bis unter 65 Jahre;4939;2400;2539
07319;      Worms, Kreisfreie Stadt;65 bis unter 75 Jahre;8281;3933;4348
07319;      Worms, Kreisfreie Stadt;75 Jahre und mehr;7510;2813;4697
07319;      Worms, Kreisfreie Stadt;Insgesamt;81967;40155;41812
07320;      Zweibrücken, Kreisfreie Stadt;unter 3 Jahre;734;356;378
07320;      Zweibrücken, Kreisfreie Stadt;3 bis unter 6 Jahre;796;411;385
07320;      Zweibrücken, Kreisfreie Stadt;6 bis unter 10 Jahre;1065;555;510
07320;      Zweibrücken, Kreisfreie Stadt;10 bis unter 15 Jahre;1671;846;825
07320;      Zweibrücken, Kreisfreie Stadt;15 bis unter 18 Jahre;1086;591;495
07320;      Zweibrücken, Kreisfreie Stadt;18 bis unter 20 Jahre;706;375;331
07320;      Zweibrücken, Kreisfreie Stadt;20 bis unter 25 Jahre;2121;1164;957
07320;      Zweibrücken, Kreisfreie Stadt;25 bis unter 30 Jahre;2065;1115;950
07320;      Zweibrücken, Kreisfreie Stadt;30 bis unter 35 Jahre;1914;1017;897
07320;      Zweibrücken, Kreisfreie Stadt;35 bis unter 40 Jahre;1804;883;921
07320;      Zweibrücken, Kreisfreie Stadt;40 bis unter 45 Jahre;2325;1199;1126
07320;      Zweibrücken, Kreisfreie Stadt;45 bis unter 50 Jahre;2614;1339;1275
07320;      Zweibrücken, Kreisfreie Stadt;50 bis unter 55 Jahre;2795;1360;1435
07320;      Zweibrücken, Kreisfreie Stadt;55 bis unter 60 Jahre;2475;1207;1268
07320;      Zweibrücken, Kreisfreie Stadt;60 bis unter 65 Jahre;2109;1046;1063
07320;      Zweibrücken, Kreisfreie Stadt;65 bis unter 75 Jahre;3820;1757;2063
07320;      Zweibrücken, Kreisfreie Stadt;75 Jahre und mehr;3707;1402;2305
07320;      Zweibrücken, Kreisfreie Stadt;Insgesamt;33807;16623;17184
07331;      Alzey-Worms, Landkreis;unter 3 Jahre;2995;1592;1403
07331;      Alzey-Worms, Landkreis;3 bis unter 6 Jahre;3200;1628;1572
07331;      Alzey-Worms, Landkreis;6 bis unter 10 Jahre;4681;2394;2287
07331;      Alzey-Worms, Landkreis;10 bis unter 15 Jahre;7007;3574;3433
07331;      Alzey-Worms, Landkreis;15 bis unter 18 Jahre;4255;2223;2032
07331;      Alzey-Worms, Landkreis;18 bis unter 20 Jahre;2945;1563;1382
07331;      Alzey-Worms, Landkreis;20 bis unter 25 Jahre;6970;3709;3261
07331;      Alzey-Worms, Landkreis;25 bis unter 30 Jahre;6386;3291;3095
07331;      Alzey-Worms, Landkreis;30 bis unter 35 Jahre;6704;3327;3377
07331;      Alzey-Worms, Landkreis;35 bis unter 40 Jahre;7072;3422;3650
07331;      Alzey-Worms, Landkreis;40 bis unter 45 Jahre;10061;4999;5062
07331;      Alzey-Worms, Landkreis;45 bis unter 50 Jahre;11527;5779;5748
07331;      Alzey-Worms, Landkreis;50 bis unter 55 Jahre;10976;5508;5468
07331;      Alzey-Worms, Landkreis;55 bis unter 60 Jahre;9551;4843;4708
07331;      Alzey-Worms, Landkreis;60 bis unter 65 Jahre;7880;4054;3826
07331;      Alzey-Worms, Landkreis;65 bis unter 75 Jahre;11634;5719;5915
07331;      Alzey-Worms, Landkreis;75 Jahre und mehr;10735;4229;6506
07331;      Alzey-Worms, Landkreis;Insgesamt;124579;61854;62725
07332;      Bad Dürkheim, Landkreis;unter 3 Jahre;2817;1431;1386
07332;      Bad Dürkheim, Landkreis;3 bis unter 6 Jahre;2988;1577;1411
07332;      Bad Dürkheim, Landkreis;6 bis unter 10 Jahre;4438;2231;2207
07332;      Bad Dürkheim, Landkreis;10 bis unter 15 Jahre;6696;3467;3229
07332;      Bad Dürkheim, Landkreis;15 bis unter 18 Jahre;4356;2249;2107
07332;      Bad Dürkheim, Landkreis;18 bis unter 20 Jahre;2958;1578;1380
07332;      Bad Dürkheim, Landkreis;20 bis unter 25 Jahre;6654;3512;3142
07332;      Bad Dürkheim, Landkreis;25 bis unter 30 Jahre;5863;2986;2877
07332;      Bad Dürkheim, Landkreis;30 bis unter 35 Jahre;6318;3071;3247
07332;      Bad Dürkheim, Landkreis;35 bis unter 40 Jahre;6931;3361;3570
07332;      Bad Dürkheim, Landkreis;40 bis unter 45 Jahre;10618;5297;5321
07332;      Bad Dürkheim, Landkreis;45 bis unter 50 Jahre;12148;6169;5979
07332;      Bad Dürkheim, Landkreis;50 bis unter 55 Jahre;11433;5693;5740
07332;      Bad Dürkheim, Landkreis;55 bis unter 60 Jahre;9766;4876;4890
07332;      Bad Dürkheim, Landkreis;60 bis unter 65 Jahre;9105;4496;4609
07332;      Bad Dürkheim, Landkreis;65 bis unter 75 Jahre;15611;7498;8113
07332;      Bad Dürkheim, Landkreis;75 Jahre und mehr;13700;5460;8240
07332;      Bad Dürkheim, Landkreis;Insgesamt;132400;64952;67448
07333;      Donnersbergkreis;unter 3 Jahre;1776;887;889
07333;      Donnersbergkreis;3 bis unter 6 Jahre;1903;945;958
07333;      Donnersbergkreis;6 bis unter 10 Jahre;2834;1452;1382
07333;      Donnersbergkreis;10 bis unter 15 Jahre;4164;2090;2074
07333;      Donnersbergkreis;15 bis unter 18 Jahre;2535;1311;1224
07333;      Donnersbergkreis;18 bis unter 20 Jahre;1789;967;822
07333;      Donnersbergkreis;20 bis unter 25 Jahre;4243;2273;1970
07333;      Donnersbergkreis;25 bis unter 30 Jahre;3794;1970;1824
07333;      Donnersbergkreis;30 bis unter 35 Jahre;3931;1920;2011
07333;      Donnersbergkreis;35 bis unter 40 Jahre;4193;2074;2119
07333;      Donnersbergkreis;40 bis unter 45 Jahre;5668;2842;2826
07333;      Donnersbergkreis;45 bis unter 50 Jahre;6809;3471;3338
07333;      Donnersbergkreis;50 bis unter 55 Jahre;6424;3220;3204
07333;      Donnersbergkreis;55 bis unter 60 Jahre;5878;2996;2882
07333;      Donnersbergkreis;60 bis unter 65 Jahre;4806;2492;2314
07333;      Donnersbergkreis;65 bis unter 75 Jahre;7389;3598;3791
07333;      Donnersbergkreis;75 Jahre und mehr;7352;2897;4455
07333;      Donnersbergkreis;Insgesamt;75488;37405;38083
07334;      Germersheim, Landkreis;unter 3 Jahre;3086;1619;1467
07334;      Germersheim, Landkreis;3 bis unter 6 Jahre;3364;1760;1604
07334;      Germersheim, Landkreis;6 bis unter 10 Jahre;4571;2409;2162
07334;      Germersheim, Landkreis;10 bis unter 15 Jahre;6546;3357;3189
07334;      Germersheim, Landkreis;15 bis unter 18 Jahre;4292;2142;2150
07334;      Germersheim, Landkreis;18 bis unter 20 Jahre;3013;1552;1461
07334;      Germersheim, Landkreis;20 bis unter 25 Jahre;7773;3958;3815
07334;      Germersheim, Landkreis;25 bis unter 30 Jahre;7129;3633;3496
07334;      Germersheim, Landkreis;30 bis unter 35 Jahre;7117;3548;3569
07334;      Germersheim, Landkreis;35 bis unter 40 Jahre;7368;3662;3706
07334;      Germersheim, Landkreis;40 bis unter 45 Jahre;9939;4953;4986
07334;      Germersheim, Landkreis;45 bis unter 50 Jahre;11461;5778;5683
07334;      Germersheim, Landkreis;50 bis unter 55 Jahre;10536;5334;5202
07334;      Germersheim, Landkreis;55 bis unter 60 Jahre;8871;4528;4343
07334;      Germersheim, Landkreis;60 bis unter 65 Jahre;7354;3690;3664
07334;      Germersheim, Landkreis;65 bis unter 75 Jahre;12297;6030;6267
07334;      Germersheim, Landkreis;75 Jahre und mehr;10285;3995;6290
07334;      Germersheim, Landkreis;Insgesamt;125002;61948;63054
07335;      Kaiserslautern, Landkreis;unter 3 Jahre;2427;1219;1208
07335;      Kaiserslautern, Landkreis;3 bis unter 6 Jahre;2544;1359;1185
07335;      Kaiserslautern, Landkreis;6 bis unter 10 Jahre;3706;1928;1778
07335;      Kaiserslautern, Landkreis;10 bis unter 15 Jahre;5741;2979;2762
07335;      Kaiserslautern, Landkreis;15 bis unter 18 Jahre;3599;1789;1810
07335;      Kaiserslautern, Landkreis;18 bis unter 20 Jahre;2508;1309;1199
07335;      Kaiserslautern, Landkreis;20 bis unter 25 Jahre;6014;3163;2851
07335;      Kaiserslautern, Landkreis;25 bis unter 30 Jahre;5510;2762;2748
07335;      Kaiserslautern, Landkreis;30 bis unter 35 Jahre;5435;2591;2844
07335;      Kaiserslautern, Landkreis;35 bis unter 40 Jahre;5619;2735;2884
07335;      Kaiserslautern, Landkreis;40 bis unter 45 Jahre;7791;3881;3910
07335;      Kaiserslautern, Landkreis;45 bis unter 50 Jahre;9084;4558;4526
07335;      Kaiserslautern, Landkreis;50 bis unter 55 Jahre;8979;4529;4450
07335;      Kaiserslautern, Landkreis;55 bis unter 60 Jahre;8017;4093;3924
07335;      Kaiserslautern, Landkreis;60 bis unter 65 Jahre;6472;3326;3146
07335;      Kaiserslautern, Landkreis;65 bis unter 75 Jahre;10824;5099;5725
07335;      Kaiserslautern, Landkreis;75 Jahre und mehr;10337;4073;6264
07335;      Kaiserslautern, Landkreis;Insgesamt;104607;51393;53214
07336;      Kusel, Landkreis;unter 3 Jahre;1510;770;740
07336;      Kusel, Landkreis;3 bis unter 6 Jahre;1606;821;785
07336;      Kusel, Landkreis;6 bis unter 10 Jahre;2389;1230;1159
07336;      Kusel, Landkreis;10 bis unter 15 Jahre;3502;1844;1658
07336;      Kusel, Landkreis;15 bis unter 18 Jahre;2386;1206;1180
07336;      Kusel, Landkreis;18 bis unter 20 Jahre;1677;919;758
07336;      Kusel, Landkreis;20 bis unter 25 Jahre;3994;2093;1901
07336;      Kusel, Landkreis;25 bis unter 30 Jahre;3609;1903;1706
07336;      Kusel, Landkreis;30 bis unter 35 Jahre;3462;1731;1731
07336;      Kusel, Landkreis;35 bis unter 40 Jahre;3658;1824;1834
07336;      Kusel, Landkreis;40 bis unter 45 Jahre;5239;2673;2566
07336;      Kusel, Landkreis;45 bis unter 50 Jahre;6122;3187;2935
07336;      Kusel, Landkreis;50 bis unter 55 Jahre;6314;3216;3098
07336;      Kusel, Landkreis;55 bis unter 60 Jahre;5747;2946;2801
07336;      Kusel, Landkreis;60 bis unter 65 Jahre;4765;2454;2311
07336;      Kusel, Landkreis;65 bis unter 75 Jahre;7696;3659;4037
07336;      Kusel, Landkreis;75 Jahre und mehr;8172;3231;4941
07336;      Kusel, Landkreis;Insgesamt;71848;35707;36141
07337;      Südliche Weinstraße, Landkreis;unter 3 Jahre;2402;1252;1150
07337;      Südliche Weinstraße, Landkreis;3 bis unter 6 Jahre;2564;1288;1276
07337;      Südliche Weinstraße, Landkreis;6 bis unter 10 Jahre;3655;1957;1698
07337;      Südliche Weinstraße, Landkreis;10 bis unter 15 Jahre;5529;2807;2722
07337;      Südliche Weinstraße, Landkreis;15 bis unter 18 Jahre;3579;1849;1730
07337;      Südliche Weinstraße, Landkreis;18 bis unter 20 Jahre;2511;1263;1248
07337;      Südliche Weinstraße, Landkreis;20 bis unter 25 Jahre;5793;3007;2786
07337;      Südliche Weinstraße, Landkreis;25 bis unter 30 Jahre;5338;2698;2640
07337;      Südliche Weinstraße, Landkreis;30 bis unter 35 Jahre;5387;2748;2639
07337;      Südliche Weinstraße, Landkreis;35 bis unter 40 Jahre;5796;2810;2986
07337;      Südliche Weinstraße, Landkreis;40 bis unter 45 Jahre;8440;4245;4195
07337;      Südliche Weinstraße, Landkreis;45 bis unter 50 Jahre;10027;5208;4819
07337;      Südliche Weinstraße, Landkreis;50 bis unter 55 Jahre;9379;4729;4650
07337;      Südliche Weinstraße, Landkreis;55 bis unter 60 Jahre;8070;4105;3965
07337;      Südliche Weinstraße, Landkreis;60 bis unter 65 Jahre;7246;3640;3606
07337;      Südliche Weinstraße, Landkreis;65 bis unter 75 Jahre;11960;5804;6156
07337;      Südliche Weinstraße, Landkreis;75 Jahre und mehr;11199;4424;6775
07337;      Südliche Weinstraße, Landkreis;Insgesamt;108875;53834;55041
07338;      Rhein-Pfalz-Kreis;unter 3 Jahre;3343;1723;1620
07338;      Rhein-Pfalz-Kreis;3 bis unter 6 Jahre;3515;1802;1713
07338;      Rhein-Pfalz-Kreis;6 bis unter 10 Jahre;4983;2539;2444
07338;      Rhein-Pfalz-Kreis;10 bis unter 15 Jahre;7515;3828;3687
07338;      Rhein-Pfalz-Kreis;15 bis unter 18 Jahre;4757;2438;2319
07338;      Rhein-Pfalz-Kreis;18 bis unter 20 Jahre;3230;1650;1580
07338;      Rhein-Pfalz-Kreis;20 bis unter 25 Jahre;7724;4005;3719
07338;      Rhein-Pfalz-Kreis;25 bis unter 30 Jahre;7145;3640;3505
07338;      Rhein-Pfalz-Kreis;30 bis unter 35 Jahre;7952;3853;4099
07338;      Rhein-Pfalz-Kreis;35 bis unter 40 Jahre;8051;3969;4082
07338;      Rhein-Pfalz-Kreis;40 bis unter 45 Jahre;11659;5735;5924
07338;      Rhein-Pfalz-Kreis;45 bis unter 50 Jahre;13892;7046;6846
07338;      Rhein-Pfalz-Kreis;50 bis unter 55 Jahre;12906;6461;6445
07338;      Rhein-Pfalz-Kreis;55 bis unter 60 Jahre;10666;5345;5321
07338;      Rhein-Pfalz-Kreis;60 bis unter 65 Jahre;9745;4774;4971
07338;      Rhein-Pfalz-Kreis;65 bis unter 75 Jahre;16980;8206;8774
07338;      Rhein-Pfalz-Kreis;75 Jahre und mehr;14949;6093;8856
07338;      Rhein-Pfalz-Kreis;Insgesamt;149012;73107;75905
07339;      Mainz-Bingen, Landkreis;unter 3 Jahre;5039;2592;2447
07339;      Mainz-Bingen, Landkreis;3 bis unter 6 Jahre;5519;2828;2691
07339;      Mainz-Bingen, Landkreis;6 bis unter 10 Jahre;7700;3923;3777
07339;      Mainz-Bingen, Landkreis;10 bis unter 15 Jahre;10922;5559;5363
07339;      Mainz-Bingen, Landkreis;15 bis unter 18 Jahre;6510;3368;3142
07339;      Mainz-Bingen, Landkreis;18 bis unter 20 Jahre;4527;2285;2242
07339;      Mainz-Bingen, Landkreis;20 bis unter 25 Jahre;10717;5493;5224
07339;      Mainz-Bingen, Landkreis;25 bis unter 30 Jahre;10197;5079;5118
07339;      Mainz-Bingen, Landkreis;30 bis unter 35 Jahre;10964;5321;5643
07339;      Mainz-Bingen, Landkreis;35 bis unter 40 Jahre;12028;5774;6254
07339;      Mainz-Bingen, Landkreis;40 bis unter 45 Jahre;17310;8607;8703
07339;      Mainz-Bingen, Landkreis;45 bis unter 50 Jahre;19189;9671;9518
07339;      Mainz-Bingen, Landkreis;50 bis unter 55 Jahre;17243;8652;8591
07339;      Mainz-Bingen, Landkreis;55 bis unter 60 Jahre;14342;7157;7185
07339;      Mainz-Bingen, Landkreis;60 bis unter 65 Jahre;12655;6273;6382
07339;      Mainz-Bingen, Landkreis;65 bis unter 75 Jahre;21023;10220;10803
07339;      Mainz-Bingen, Landkreis;75 Jahre und mehr;17007;6782;10225
07339;      Mainz-Bingen, Landkreis;Insgesamt;202892;99584;103308
07340;      Südwestpfalz, Landkreis;unter 3 Jahre;1891;947;944
07340;      Südwestpfalz, Landkreis;3 bis unter 6 Jahre;2038;1025;1013
07340;      Südwestpfalz, Landkreis;6 bis unter 10 Jahre;2950;1574;1376
07340;      Südwestpfalz, Landkreis;10 bis unter 15 Jahre;4745;2485;2260
07340;      Südwestpfalz, Landkreis;15 bis unter 18 Jahre;3170;1674;1496
07340;      Südwestpfalz, Landkreis;18 bis unter 20 Jahre;2284;1142;1142
07340;      Südwestpfalz, Landkreis;20 bis unter 25 Jahre;5386;2896;2490
07340;      Südwestpfalz, Landkreis;25 bis unter 30 Jahre;4685;2457;2228
07340;      Südwestpfalz, Landkreis;30 bis unter 35 Jahre;4698;2331;2367
07340;      Südwestpfalz, Landkreis;35 bis unter 40 Jahre;4945;2460;2485
07340;      Südwestpfalz, Landkreis;40 bis unter 45 Jahre;7422;3771;3651
07340;      Südwestpfalz, Landkreis;45 bis unter 50 Jahre;8800;4433;4367
07340;      Südwestpfalz, Landkreis;50 bis unter 55 Jahre;8452;4284;4168
07340;      Südwestpfalz, Landkreis;55 bis unter 60 Jahre;7649;3878;3771
07340;      Südwestpfalz, Landkreis;60 bis unter 65 Jahre;6441;3248;3193
07340;      Südwestpfalz, Landkreis;65 bis unter 75 Jahre;11262;5445;5817
07340;      Südwestpfalz, Landkreis;75 Jahre und mehr;11296;4618;6678
07340;      Südwestpfalz, Landkreis;Insgesamt;98114;48668;49446
08;  Baden-Württemberg;unter 3 Jahre;271902;139246;132656
08;  Baden-Württemberg;3 bis unter 6 Jahre;281538;143765;137773
08;  Baden-Württemberg;6 bis unter 10 Jahre;393259;202335;190924
08;  Baden-Württemberg;10 bis unter 15 Jahre;556242;285392;270850
08;  Baden-Württemberg;15 bis unter 18 Jahre;349033;179330;169703
08;  Baden-Württemberg;18 bis unter 20 Jahre;247958;127566;120392
08;  Baden-Württemberg;20 bis unter 25 Jahre;667915;341542;326373
08;  Baden-Württemberg;25 bis unter 30 Jahre;658091;333658;324433
08;  Baden-Württemberg;30 bis unter 35 Jahre;654245;327834;326411
08;  Baden-Württemberg;35 bis unter 40 Jahre;653237;327848;325389
08;  Baden-Württemberg;40 bis unter 45 Jahre;854171;434536;419635
08;  Baden-Württemberg;45 bis unter 50 Jahre;944488;484552;459936
08;  Baden-Württemberg;50 bis unter 55 Jahre;837126;425060;412066
08;  Baden-Württemberg;55 bis unter 60 Jahre;700368;348042;352326
08;  Baden-Württemberg;60 bis unter 65 Jahre;614426;302644;311782
08;  Baden-Württemberg;65 bis unter 75 Jahre;1112522;529716;582806
08;  Baden-Württemberg;75 Jahre und mehr;989706;387383;602323
08;  Baden-Württemberg;Insgesamt;10786227;5320449;5465778
081;    Stuttgart, Regierungsbezirk;unter 3 Jahre;103098;52663;50435
081;    Stuttgart, Regierungsbezirk;3 bis unter 6 Jahre;106788;54415;52373
081;    Stuttgart, Regierungsbezirk;6 bis unter 10 Jahre;148416;76155;72261
081;    Stuttgart, Regierungsbezirk;10 bis unter 15 Jahre;207052;106448;100604
081;    Stuttgart, Regierungsbezirk;15 bis unter 18 Jahre;129675;66489;63186
081;    Stuttgart, Regierungsbezirk;18 bis unter 20 Jahre;90363;46549;43814
081;    Stuttgart, Regierungsbezirk;20 bis unter 25 Jahre;236405;121714;114691
081;    Stuttgart, Regierungsbezirk;25 bis unter 30 Jahre;243958;123745;120213
081;    Stuttgart, Regierungsbezirk;30 bis unter 35 Jahre;253617;127348;126269
081;    Stuttgart, Regierungsbezirk;35 bis unter 40 Jahre;253986;128540;125446
081;    Stuttgart, Regierungsbezirk;40 bis unter 45 Jahre;322913;165792;157121
081;    Stuttgart, Regierungsbezirk;45 bis unter 50 Jahre;347305;180240;167065
081;    Stuttgart, Regierungsbezirk;50 bis unter 55 Jahre;304921;155541;149380
081;    Stuttgart, Regierungsbezirk;55 bis unter 60 Jahre;255768;126794;128974
081;    Stuttgart, Regierungsbezirk;60 bis unter 65 Jahre;226703;111135;115568
081;    Stuttgart, Regierungsbezirk;65 bis unter 75 Jahre;419750;199983;219767
081;    Stuttgart, Regierungsbezirk;75 Jahre und mehr;365294;144325;220969
081;    Stuttgart, Regierungsbezirk;Insgesamt;4016012;1987876;2028136
08111;      Stuttgart, Landeshauptstadt, Kreisfreie Stadt;unter 3 Jahre;16425;8391;8034
08111;      Stuttgart, Landeshauptstadt, Kreisfreie Stadt;3 bis unter 6 Jahre;15296;7788;7508
08111;      Stuttgart, Landeshauptstadt, Kreisfreie Stadt;6 bis unter 10 Jahre;19026;9778;9248
08111;      Stuttgart, Landeshauptstadt, Kreisfreie Stadt;10 bis unter 15 Jahre;24195;12426;11769
08111;      Stuttgart, Landeshauptstadt, Kreisfreie Stadt;15 bis unter 18 Jahre;14616;7588;7028
08111;      Stuttgart, Landeshauptstadt, Kreisfreie Stadt;18 bis unter 20 Jahre;11025;5682;5343
08111;      Stuttgart, Landeshauptstadt, Kreisfreie Stadt;20 bis unter 25 Jahre;41325;20330;20995
08111;      Stuttgart, Landeshauptstadt, Kreisfreie Stadt;25 bis unter 30 Jahre;50440;24927;25513
08111;      Stuttgart, Landeshauptstadt, Kreisfreie Stadt;30 bis unter 35 Jahre;50714;25766;24948
08111;      Stuttgart, Landeshauptstadt, Kreisfreie Stadt;35 bis unter 40 Jahre;45288;23711;21577
08111;      Stuttgart, Landeshauptstadt, Kreisfreie Stadt;40 bis unter 45 Jahre;50204;26633;23571
08111;      Stuttgart, Landeshauptstadt, Kreisfreie Stadt;45 bis unter 50 Jahre;50881;27554;23327
08111;      Stuttgart, Landeshauptstadt, Kreisfreie Stadt;50 bis unter 55 Jahre;42413;22323;20090
08111;      Stuttgart, Landeshauptstadt, Kreisfreie Stadt;55 bis unter 60 Jahre;34985;17437;17548
08111;      Stuttgart, Landeshauptstadt, Kreisfreie Stadt;60 bis unter 65 Jahre;32103;15801;16302
08111;      Stuttgart, Landeshauptstadt, Kreisfreie Stadt;65 bis unter 75 Jahre;60773;28820;31953
08111;      Stuttgart, Landeshauptstadt, Kreisfreie Stadt;75 Jahre und mehr;53683;20392;33291
08111;      Stuttgart, Landeshauptstadt, Kreisfreie Stadt;Insgesamt;613392;305347;308045
08115;      Böblingen, Landkreis;unter 3 Jahre;10009;5071;4938
08115;      Böblingen, Landkreis;3 bis unter 6 Jahre;10489;5367;5122
08115;      Böblingen, Landkreis;6 bis unter 10 Jahre;14309;7439;6870
08115;      Böblingen, Landkreis;10 bis unter 15 Jahre;20047;10337;9710
08115;      Böblingen, Landkreis;15 bis unter 18 Jahre;12331;6319;6012
08115;      Böblingen, Landkreis;18 bis unter 20 Jahre;8319;4243;4076
08115;      Böblingen, Landkreis;20 bis unter 25 Jahre;20619;10690;9929
08115;      Böblingen, Landkreis;25 bis unter 30 Jahre;21339;10816;10523
08115;      Böblingen, Landkreis;30 bis unter 35 Jahre;23105;11517;11588
08115;      Böblingen, Landkreis;35 bis unter 40 Jahre;23390;11707;11683
08115;      Böblingen, Landkreis;40 bis unter 45 Jahre;30728;15719;15009
08115;      Böblingen, Landkreis;45 bis unter 50 Jahre;32304;16447;15857
08115;      Böblingen, Landkreis;50 bis unter 55 Jahre;28404;14376;14028
08115;      Böblingen, Landkreis;55 bis unter 60 Jahre;23668;11579;12089
08115;      Böblingen, Landkreis;60 bis unter 65 Jahre;20673;10033;10640
08115;      Böblingen, Landkreis;65 bis unter 75 Jahre;40500;19485;21015
08115;      Böblingen, Landkreis;75 Jahre und mehr;32100;13111;18989
08115;      Böblingen, Landkreis;Insgesamt;372334;184256;188078
08116;      Esslingen, Landkreis;unter 3 Jahre;13557;6935;6622
08116;      Esslingen, Landkreis;3 bis unter 6 Jahre;14027;7206;6821
08116;      Esslingen, Landkreis;6 bis unter 10 Jahre;19342;9984;9358
08116;      Esslingen, Landkreis;10 bis unter 15 Jahre;26749;13695;13054
08116;      Esslingen, Landkreis;15 bis unter 18 Jahre;16575;8427;8148
08116;      Esslingen, Landkreis;18 bis unter 20 Jahre;11298;5780;5518
08116;      Esslingen, Landkreis;20 bis unter 25 Jahre;29128;14953;14175
08116;      Esslingen, Landkreis;25 bis unter 30 Jahre;29745;14932;14813
08116;      Esslingen, Landkreis;30 bis unter 35 Jahre;31719;15680;16039
08116;      Esslingen, Landkreis;35 bis unter 40 Jahre;32557;16301;16256
08116;      Esslingen, Landkreis;40 bis unter 45 Jahre;41470;20907;20563
08116;      Esslingen, Landkreis;45 bis unter 50 Jahre;45621;23419;22202
08116;      Esslingen, Landkreis;50 bis unter 55 Jahre;39155;19847;19308
08116;      Esslingen, Landkreis;55 bis unter 60 Jahre;32446;15983;16463
08116;      Esslingen, Landkreis;60 bis unter 65 Jahre;29567;14267;15300
08116;      Esslingen, Landkreis;65 bis unter 75 Jahre;56817;27072;29745
08116;      Esslingen, Landkreis;75 Jahre und mehr;47432;19256;28176
08116;      Esslingen, Landkreis;Insgesamt;517205;254644;262561
08117;      Göppingen, Landkreis;unter 3 Jahre;5968;3055;2913
08117;      Göppingen, Landkreis;3 bis unter 6 Jahre;6398;3205;3193
08117;      Göppingen, Landkreis;6 bis unter 10 Jahre;9153;4683;4470
08117;      Göppingen, Landkreis;10 bis unter 15 Jahre;13529;7014;6515
08117;      Göppingen, Landkreis;15 bis unter 18 Jahre;8525;4384;4141
08117;      Göppingen, Landkreis;18 bis unter 20 Jahre;6135;3244;2891
08117;      Göppingen, Landkreis;20 bis unter 25 Jahre;14486;7589;6897
08117;      Göppingen, Landkreis;25 bis unter 30 Jahre;13858;7167;6691
08117;      Göppingen, Landkreis;30 bis unter 35 Jahre;14064;7003;7061
08117;      Göppingen, Landkreis;35 bis unter 40 Jahre;14804;7379;7425
08117;      Göppingen, Landkreis;40 bis unter 45 Jahre;19928;10132;9796
08117;      Göppingen, Landkreis;45 bis unter 50 Jahre;21552;11163;10389
08117;      Göppingen, Landkreis;50 bis unter 55 Jahre;19429;9797;9632
08117;      Göppingen, Landkreis;55 bis unter 60 Jahre;16548;8279;8269
08117;      Göppingen, Landkreis;60 bis unter 65 Jahre;14965;7284;7681
08117;      Göppingen, Landkreis;65 bis unter 75 Jahre;27907;13237;14670
08117;      Göppingen, Landkreis;75 Jahre und mehr;24753;9850;14903
08117;      Göppingen, Landkreis;Insgesamt;252002;124465;127537
08118;      Ludwigsburg, Landkreis;unter 3 Jahre;14251;7267;6984
08118;      Ludwigsburg, Landkreis;3 bis unter 6 Jahre;14701;7507;7194
08118;      Ludwigsburg, Landkreis;6 bis unter 10 Jahre;19817;10172;9645
08118;      Ludwigsburg, Landkreis;10 bis unter 15 Jahre;27308;14141;13167
08118;      Ludwigsburg, Landkreis;15 bis unter 18 Jahre;16846;8616;8230
08118;      Ludwigsburg, Landkreis;18 bis unter 20 Jahre;11666;5990;5676
08118;      Ludwigsburg, Landkreis;20 bis unter 25 Jahre;29104;14783;14321
08118;      Ludwigsburg, Landkreis;25 bis unter 30 Jahre;29585;14673;14912
08118;      Ludwigsburg, Landkreis;30 bis unter 35 Jahre;33228;16571;16657
08118;      Ludwigsburg, Landkreis;35 bis unter 40 Jahre;33529;16881;16648
08118;      Ludwigsburg, Landkreis;40 bis unter 45 Jahre;43086;22067;21019
08118;      Ludwigsburg, Landkreis;45 bis unter 50 Jahre;45460;23499;21961
08118;      Ludwigsburg, Landkreis;50 bis unter 55 Jahre;39205;19779;19426
08118;      Ludwigsburg, Landkreis;55 bis unter 60 Jahre;32792;16173;16619
08118;      Ludwigsburg, Landkreis;60 bis unter 65 Jahre;29314;14220;15094
08118;      Ludwigsburg, Landkreis;65 bis unter 75 Jahre;55546;26393;29153
08118;      Ludwigsburg, Landkreis;75 Jahre und mehr;45576;18381;27195
08118;      Ludwigsburg, Landkreis;Insgesamt;521014;257113;263901
08119;      Rems-Murr-Kreis;unter 3 Jahre;10074;5175;4899
08119;      Rems-Murr-Kreis;3 bis unter 6 Jahre;10852;5507;5345
08119;      Rems-Murr-Kreis;6 bis unter 10 Jahre;15726;8052;7674
08119;      Rems-Murr-Kreis;10 bis unter 15 Jahre;22353;11328;11025
08119;      Rems-Murr-Kreis;15 bis unter 18 Jahre;14184;7241;6943
08119;      Rems-Murr-Kreis;18 bis unter 20 Jahre;9635;4972;4663
08119;      Rems-Murr-Kreis;20 bis unter 25 Jahre;22941;11957;10984
08119;      Rems-Murr-Kreis;25 bis unter 30 Jahre;22342;11328;11014
08119;      Rems-Murr-Kreis;30 bis unter 35 Jahre;23579;11645;11934
08119;      Rems-Murr-Kreis;35 bis unter 40 Jahre;24922;12354;12568
08119;      Rems-Murr-Kreis;40 bis unter 45 Jahre;33992;17236;16756
08119;      Rems-Murr-Kreis;45 bis unter 50 Jahre;37233;19091;18142
08119;      Rems-Murr-Kreis;50 bis unter 55 Jahre;32352;16468;15884
08119;      Rems-Murr-Kreis;55 bis unter 60 Jahre;27102;13334;13768
08119;      Rems-Murr-Kreis;60 bis unter 65 Jahre;23930;11655;12275
08119;      Rems-Murr-Kreis;65 bis unter 75 Jahre;45738;21712;24026
08119;      Rems-Murr-Kreis;75 Jahre und mehr;38764;15535;23229
08119;      Rems-Murr-Kreis;Insgesamt;415719;204590;211129
08121;      Heilbronn, Kreisfreie Stadt;unter 3 Jahre;3283;1698;1585
08121;      Heilbronn, Kreisfreie Stadt;3 bis unter 6 Jahre;3394;1744;1650
08121;      Heilbronn, Kreisfreie Stadt;6 bis unter 10 Jahre;4508;2349;2159
08121;      Heilbronn, Kreisfreie Stadt;10 bis unter 15 Jahre;5798;3003;2795
08121;      Heilbronn, Kreisfreie Stadt;15 bis unter 18 Jahre;3606;1817;1789
08121;      Heilbronn, Kreisfreie Stadt;18 bis unter 20 Jahre;2678;1317;1361
08121;      Heilbronn, Kreisfreie Stadt;20 bis unter 25 Jahre;7982;4066;3916
08121;      Heilbronn, Kreisfreie Stadt;25 bis unter 30 Jahre;8543;4360;4183
08121;      Heilbronn, Kreisfreie Stadt;30 bis unter 35 Jahre;8559;4395;4164
08121;      Heilbronn, Kreisfreie Stadt;35 bis unter 40 Jahre;8120;4274;3846
08121;      Heilbronn, Kreisfreie Stadt;40 bis unter 45 Jahre;9376;4959;4417
08121;      Heilbronn, Kreisfreie Stadt;45 bis unter 50 Jahre;9984;5341;4643
08121;      Heilbronn, Kreisfreie Stadt;50 bis unter 55 Jahre;9077;4642;4435
08121;      Heilbronn, Kreisfreie Stadt;55 bis unter 60 Jahre;7626;3736;3890
08121;      Heilbronn, Kreisfreie Stadt;60 bis unter 65 Jahre;6795;3300;3495
08121;      Heilbronn, Kreisfreie Stadt;65 bis unter 75 Jahre;13197;6262;6935
08121;      Heilbronn, Kreisfreie Stadt;75 Jahre und mehr;11731;4435;7296
08121;      Heilbronn, Kreisfreie Stadt;Insgesamt;124257;61698;62559
08125;      Heilbronn, Landkreis;unter 3 Jahre;8147;4103;4044
08125;      Heilbronn, Landkreis;3 bis unter 6 Jahre;8689;4431;4258
08125;      Heilbronn, Landkreis;6 bis unter 10 Jahre;12851;6491;6360
08125;      Heilbronn, Landkreis;10 bis unter 15 Jahre;18836;9648;9188
08125;      Heilbronn, Landkreis;15 bis unter 18 Jahre;11835;6104;5731
08125;      Heilbronn, Landkreis;18 bis unter 20 Jahre;8013;4181;3832
08125;      Heilbronn, Landkreis;20 bis unter 25 Jahre;19124;10054;9070
08125;      Heilbronn, Landkreis;25 bis unter 30 Jahre;18446;9490;8956
08125;      Heilbronn, Landkreis;30 bis unter 35 Jahre;19357;9802;9555
08125;      Heilbronn, Landkreis;35 bis unter 40 Jahre;20343;10138;10205
08125;      Heilbronn, Landkreis;40 bis unter 45 Jahre;26954;13849;13105
08125;      Heilbronn, Landkreis;45 bis unter 50 Jahre;29585;15168;14417
08125;      Heilbronn, Landkreis;50 bis unter 55 Jahre;26085;13461;12624
08125;      Heilbronn, Landkreis;55 bis unter 60 Jahre;21624;10806;10818
08125;      Heilbronn, Landkreis;60 bis unter 65 Jahre;18752;9238;9514
08125;      Heilbronn, Landkreis;65 bis unter 75 Jahre;32170;15437;16733
08125;      Heilbronn, Landkreis;75 Jahre und mehr;27920;11096;16824
08125;      Heilbronn, Landkreis;Insgesamt;328731;163497;165234
08126;      Hohenlohekreis;unter 3 Jahre;2785;1447;1338
08126;      Hohenlohekreis;3 bis unter 6 Jahre;2949;1527;1422
08126;      Hohenlohekreis;6 bis unter 10 Jahre;4203;2136;2067
08126;      Hohenlohekreis;10 bis unter 15 Jahre;6139;3230;2909
08126;      Hohenlohekreis;15 bis unter 18 Jahre;3911;1995;1916
08126;      Hohenlohekreis;18 bis unter 20 Jahre;2717;1361;1356
08126;      Hohenlohekreis;20 bis unter 25 Jahre;6830;3570;3260
08126;      Hohenlohekreis;25 bis unter 30 Jahre;6286;3361;2925
08126;      Hohenlohekreis;30 bis unter 35 Jahre;6267;3156;3111
08126;      Hohenlohekreis;35 bis unter 40 Jahre;6501;3327;3174
08126;      Hohenlohekreis;40 bis unter 45 Jahre;8490;4317;4173
08126;      Hohenlohekreis;45 bis unter 50 Jahre;9545;4939;4606
08126;      Hohenlohekreis;50 bis unter 55 Jahre;8778;4525;4253
08126;      Hohenlohekreis;55 bis unter 60 Jahre;7347;3711;3636
08126;      Hohenlohekreis;60 bis unter 65 Jahre;6153;3187;2966
08126;      Hohenlohekreis;65 bis unter 75 Jahre;10130;4861;5269
08126;      Hohenlohekreis;75 Jahre und mehr;9801;3855;5946
08126;      Hohenlohekreis;Insgesamt;108832;54505;54327
08127;      Schwäbisch Hall, Landkreis;unter 3 Jahre;4766;2420;2346
08127;      Schwäbisch Hall, Landkreis;3 bis unter 6 Jahre;5120;2587;2533
08127;      Schwäbisch Hall, Landkreis;6 bis unter 10 Jahre;7526;3876;3650
08127;      Schwäbisch Hall, Landkreis;10 bis unter 15 Jahre;10673;5511;5162
08127;      Schwäbisch Hall, Landkreis;15 bis unter 18 Jahre;7002;3537;3465
08127;      Schwäbisch Hall, Landkreis;18 bis unter 20 Jahre;4858;2531;2327
08127;      Schwäbisch Hall, Landkreis;20 bis unter 25 Jahre;11316;6027;5289
08127;      Schwäbisch Hall, Landkreis;25 bis unter 30 Jahre;11324;6008;5316
08127;      Schwäbisch Hall, Landkreis;30 bis unter 35 Jahre;11058;5600;5458
08127;      Schwäbisch Hall, Landkreis;35 bis unter 40 Jahre;11061;5651;5410
08127;      Schwäbisch Hall, Landkreis;40 bis unter 45 Jahre;14580;7502;7078
08127;      Schwäbisch Hall, Landkreis;45 bis unter 50 Jahre;16278;8359;7919
08127;      Schwäbisch Hall, Landkreis;50 bis unter 55 Jahre;14984;7621;7363
08127;      Schwäbisch Hall, Landkreis;55 bis unter 60 Jahre;13043;6420;6623
08127;      Schwäbisch Hall, Landkreis;60 bis unter 65 Jahre;10795;5445;5350
08127;      Schwäbisch Hall, Landkreis;65 bis unter 75 Jahre;17500;8312;9188
08127;      Schwäbisch Hall, Landkreis;75 Jahre und mehr;16565;6335;10230
08127;      Schwäbisch Hall, Landkreis;Insgesamt;188449;93742;94707
08128;      Main-Tauber-Kreis;unter 3 Jahre;2921;1491;1430
08128;      Main-Tauber-Kreis;3 bis unter 6 Jahre;3271;1658;1613
08128;      Main-Tauber-Kreis;6 bis unter 10 Jahre;4853;2508;2345
08128;      Main-Tauber-Kreis;10 bis unter 15 Jahre;6978;3557;3421
08128;      Main-Tauber-Kreis;15 bis unter 18 Jahre;4561;2322;2239
08128;      Main-Tauber-Kreis;18 bis unter 20 Jahre;3170;1649;1521
08128;      Main-Tauber-Kreis;20 bis unter 25 Jahre;7493;3963;3530
08128;      Main-Tauber-Kreis;25 bis unter 30 Jahre;7211;3788;3423
08128;      Main-Tauber-Kreis;30 bis unter 35 Jahre;7276;3734;3542
08128;      Main-Tauber-Kreis;35 bis unter 40 Jahre;7455;3707;3748
08128;      Main-Tauber-Kreis;40 bis unter 45 Jahre;10003;5131;4872
08128;      Main-Tauber-Kreis;45 bis unter 50 Jahre;11598;5994;5604
08128;      Main-Tauber-Kreis;50 bis unter 55 Jahre;10666;5345;5321
08128;      Main-Tauber-Kreis;55 bis unter 60 Jahre;9383;4688;4695
08128;      Main-Tauber-Kreis;60 bis unter 65 Jahre;8347;4165;4182
08128;      Main-Tauber-Kreis;65 bis unter 75 Jahre;13805;6671;7134
08128;      Main-Tauber-Kreis;75 Jahre und mehr;14002;5411;8591
08128;      Main-Tauber-Kreis;Insgesamt;132993;65782;67211
08135;      Heidenheim, Landkreis;unter 3 Jahre;3044;1567;1477
08135;      Heidenheim, Landkreis;3 bis unter 6 Jahre;3217;1657;1560
08135;      Heidenheim, Landkreis;6 bis unter 10 Jahre;4829;2458;2371
08135;      Heidenheim, Landkreis;10 bis unter 15 Jahre;6977;3649;3328
08135;      Heidenheim, Landkreis;15 bis unter 18 Jahre;4483;2283;2200
08135;      Heidenheim, Landkreis;18 bis unter 20 Jahre;3140;1608;1532
08135;      Heidenheim, Landkreis;20 bis unter 25 Jahre;7489;4079;3410
08135;      Heidenheim, Landkreis;25 bis unter 30 Jahre;7285;3882;3403
08135;      Heidenheim, Landkreis;30 bis unter 35 Jahre;7072;3542;3530
08135;      Heidenheim, Landkreis;35 bis unter 40 Jahre;7298;3624;3674
08135;      Heidenheim, Landkreis;40 bis unter 45 Jahre;9962;5062;4900
08135;      Heidenheim, Landkreis;45 bis unter 50 Jahre;10989;5661;5328
08135;      Heidenheim, Landkreis;50 bis unter 55 Jahre;10192;5083;5109
08135;      Heidenheim, Landkreis;55 bis unter 60 Jahre;8629;4398;4231
08135;      Heidenheim, Landkreis;60 bis unter 65 Jahre;7726;3829;3897
08135;      Heidenheim, Landkreis;65 bis unter 75 Jahre;14235;6691;7544
08135;      Heidenheim, Landkreis;75 Jahre und mehr;14152;5524;8628
08135;      Heidenheim, Landkreis;Insgesamt;130719;64597;66122
08136;      Ostalbkreis;unter 3 Jahre;7868;4043;3825
08136;      Ostalbkreis;3 bis unter 6 Jahre;8385;4231;4154
08136;      Ostalbkreis;6 bis unter 10 Jahre;12273;6229;6044
08136;      Ostalbkreis;10 bis unter 15 Jahre;17470;8909;8561
08136;      Ostalbkreis;15 bis unter 18 Jahre;11200;5856;5344
08136;      Ostalbkreis;18 bis unter 20 Jahre;7709;3991;3718
08136;      Ostalbkreis;20 bis unter 25 Jahre;18568;9653;8915
08136;      Ostalbkreis;25 bis unter 30 Jahre;17554;9013;8541
08136;      Ostalbkreis;30 bis unter 35 Jahre;17619;8937;8682
08136;      Ostalbkreis;35 bis unter 40 Jahre;18718;9486;9232
08136;      Ostalbkreis;40 bis unter 45 Jahre;24140;12278;11862
08136;      Ostalbkreis;45 bis unter 50 Jahre;26275;13605;12670
08136;      Ostalbkreis;50 bis unter 55 Jahre;24181;12274;11907
08136;      Ostalbkreis;55 bis unter 60 Jahre;20575;10250;10325
08136;      Ostalbkreis;60 bis unter 65 Jahre;17583;8711;8872
08136;      Ostalbkreis;65 bis unter 75 Jahre;31432;15030;16402
08136;      Ostalbkreis;75 Jahre und mehr;28815;11144;17671
08136;      Ostalbkreis;Insgesamt;310365;153640;156725
082;    Karlsruhe, Regierungsbezirk;unter 3 Jahre;66979;34369;32610
082;    Karlsruhe, Regierungsbezirk;3 bis unter 6 Jahre;68494;35202;33292
082;    Karlsruhe, Regierungsbezirk;6 bis unter 10 Jahre;95362;49159;46203
082;    Karlsruhe, Regierungsbezirk;10 bis unter 15 Jahre;133991;68663;65328
082;    Karlsruhe, Regierungsbezirk;15 bis unter 18 Jahre;84212;43197;41015
082;    Karlsruhe, Regierungsbezirk;18 bis unter 20 Jahre;61410;31760;29650
082;    Karlsruhe, Regierungsbezirk;20 bis unter 25 Jahre;174579;89976;84603
082;    Karlsruhe, Regierungsbezirk;25 bis unter 30 Jahre;172341;87655;84686
082;    Karlsruhe, Regierungsbezirk;30 bis unter 35 Jahre;167923;84341;83582
082;    Karlsruhe, Regierungsbezirk;35 bis unter 40 Jahre;163845;81866;81979
082;    Karlsruhe, Regierungsbezirk;40 bis unter 45 Jahre;216912;110336;106576
082;    Karlsruhe, Regierungsbezirk;45 bis unter 50 Jahre;243602;124235;119367
082;    Karlsruhe, Regierungsbezirk;50 bis unter 55 Jahre;217312;110511;106801
082;    Karlsruhe, Regierungsbezirk;55 bis unter 60 Jahre;180963;90081;90882
082;    Karlsruhe, Regierungsbezirk;60 bis unter 65 Jahre;162004;79545;82459
082;    Karlsruhe, Regierungsbezirk;65 bis unter 75 Jahre;285204;135757;149447
082;    Karlsruhe, Regierungsbezirk;75 Jahre und mehr;256774;99306;157468
082;    Karlsruhe, Regierungsbezirk;Insgesamt;2751907;1355959;1395948
08211;      Baden-Baden, Kreisfreie Stadt;unter 3 Jahre;1085;561;524
08211;      Baden-Baden, Kreisfreie Stadt;3 bis unter 6 Jahre;1118;584;534
08211;      Baden-Baden, Kreisfreie Stadt;6 bis unter 10 Jahre;1625;811;814
08211;      Baden-Baden, Kreisfreie Stadt;10 bis unter 15 Jahre;2294;1152;1142
08211;      Baden-Baden, Kreisfreie Stadt;15 bis unter 18 Jahre;1421;739;682
08211;      Baden-Baden, Kreisfreie Stadt;18 bis unter 20 Jahre;1044;530;514
08211;      Baden-Baden, Kreisfreie Stadt;20 bis unter 25 Jahre;2549;1348;1201
08211;      Baden-Baden, Kreisfreie Stadt;25 bis unter 30 Jahre;2672;1336;1336
08211;      Baden-Baden, Kreisfreie Stadt;30 bis unter 35 Jahre;2824;1376;1448
08211;      Baden-Baden, Kreisfreie Stadt;35 bis unter 40 Jahre;2754;1290;1464
08211;      Baden-Baden, Kreisfreie Stadt;40 bis unter 45 Jahre;4182;2017;2165
08211;      Baden-Baden, Kreisfreie Stadt;45 bis unter 50 Jahre;4617;2225;2392
08211;      Baden-Baden, Kreisfreie Stadt;50 bis unter 55 Jahre;4255;2036;2219
08211;      Baden-Baden, Kreisfreie Stadt;55 bis unter 60 Jahre;3722;1767;1955
08211;      Baden-Baden, Kreisfreie Stadt;60 bis unter 65 Jahre;3749;1766;1983
08211;      Baden-Baden, Kreisfreie Stadt;65 bis unter 75 Jahre;7269;3251;4018
08211;      Baden-Baden, Kreisfreie Stadt;75 Jahre und mehr;7281;2692;4589
08211;      Baden-Baden, Kreisfreie Stadt;Insgesamt;54461;25481;28980
08212;      Karlsruhe, Kreisfreie Stadt;unter 3 Jahre;7471;3837;3634
08212;      Karlsruhe, Kreisfreie Stadt;3 bis unter 6 Jahre;7032;3530;3502
08212;      Karlsruhe, Kreisfreie Stadt;6 bis unter 10 Jahre;9102;4709;4393
08212;      Karlsruhe, Kreisfreie Stadt;10 bis unter 15 Jahre;11698;5954;5744
08212;      Karlsruhe, Kreisfreie Stadt;15 bis unter 18 Jahre;7008;3616;3392
08212;      Karlsruhe, Kreisfreie Stadt;18 bis unter 20 Jahre;6144;3306;2838
08212;      Karlsruhe, Kreisfreie Stadt;20 bis unter 25 Jahre;24050;13476;10574
08212;      Karlsruhe, Kreisfreie Stadt;25 bis unter 30 Jahre;24363;13069;11294
08212;      Karlsruhe, Kreisfreie Stadt;30 bis unter 35 Jahre;21862;11510;10352
08212;      Karlsruhe, Kreisfreie Stadt;35 bis unter 40 Jahre;19542;10281;9261
08212;      Karlsruhe, Kreisfreie Stadt;40 bis unter 45 Jahre;23231;12233;10998
08212;      Karlsruhe, Kreisfreie Stadt;45 bis unter 50 Jahre;24017;12546;11471
08212;      Karlsruhe, Kreisfreie Stadt;50 bis unter 55 Jahre;21653;11250;10403
08212;      Karlsruhe, Kreisfreie Stadt;55 bis unter 60 Jahre;17685;8795;8890
08212;      Karlsruhe, Kreisfreie Stadt;60 bis unter 65 Jahre;15884;7619;8265
08212;      Karlsruhe, Kreisfreie Stadt;65 bis unter 75 Jahre;29270;13631;15639
08212;      Karlsruhe, Kreisfreie Stadt;75 Jahre und mehr;27476;10197;17279
08212;      Karlsruhe, Kreisfreie Stadt;Insgesamt;297488;149559;147929
08215;      Karlsruhe, Landkreis;unter 3 Jahre;10401;5383;5018
08215;      Karlsruhe, Landkreis;3 bis unter 6 Jahre;11181;5791;5390
08215;      Karlsruhe, Landkreis;6 bis unter 10 Jahre;15563;8052;7511
08215;      Karlsruhe, Landkreis;10 bis unter 15 Jahre;22696;11752;10944
08215;      Karlsruhe, Landkreis;15 bis unter 18 Jahre;14361;7403;6958
08215;      Karlsruhe, Landkreis;18 bis unter 20 Jahre;9857;5115;4742
08215;      Karlsruhe, Landkreis;20 bis unter 25 Jahre;24309;12668;11641
08215;      Karlsruhe, Landkreis;25 bis unter 30 Jahre;23599;12077;11522
08215;      Karlsruhe, Landkreis;30 bis unter 35 Jahre;24669;12250;12419
08215;      Karlsruhe, Landkreis;35 bis unter 40 Jahre;25449;12478;12971
08215;      Karlsruhe, Landkreis;40 bis unter 45 Jahre;34455;17389;17066
08215;      Karlsruhe, Landkreis;45 bis unter 50 Jahre;39059;19713;19346
08215;      Karlsruhe, Landkreis;50 bis unter 55 Jahre;35399;17990;17409
08215;      Karlsruhe, Landkreis;55 bis unter 60 Jahre;29651;14715;14936
08215;      Karlsruhe, Landkreis;60 bis unter 65 Jahre;27012;13409;13603
08215;      Karlsruhe, Landkreis;65 bis unter 75 Jahre;45366;21703;23663
08215;      Karlsruhe, Landkreis;75 Jahre und mehr;39950;15792;24158
08215;      Karlsruhe, Landkreis;Insgesamt;432977;213680;219297
08216;      Rastatt, Landkreis;unter 3 Jahre;5326;2735;2591
08216;      Rastatt, Landkreis;3 bis unter 6 Jahre;5538;2866;2672
08216;      Rastatt, Landkreis;6 bis unter 10 Jahre;8127;4226;3901
08216;      Rastatt, Landkreis;10 bis unter 15 Jahre;11818;6045;5773
08216;      Rastatt, Landkreis;15 bis unter 18 Jahre;7564;3886;3678
08216;      Rastatt, Landkreis;18 bis unter 20 Jahre;5234;2721;2513
08216;      Rastatt, Landkreis;20 bis unter 25 Jahre;12472;6506;5966
08216;      Rastatt, Landkreis;25 bis unter 30 Jahre;12447;6384;6063
08216;      Rastatt, Landkreis;30 bis unter 35 Jahre;12339;6065;6274
08216;      Rastatt, Landkreis;35 bis unter 40 Jahre;12931;6314;6617
08216;      Rastatt, Landkreis;40 bis unter 45 Jahre;17771;8927;8844
08216;      Rastatt, Landkreis;45 bis unter 50 Jahre;20371;10421;9950
08216;      Rastatt, Landkreis;50 bis unter 55 Jahre;18920;9598;9322
08216;      Rastatt, Landkreis;55 bis unter 60 Jahre;16129;8114;8015
08216;      Rastatt, Landkreis;60 bis unter 65 Jahre;13738;6828;6910
08216;      Rastatt, Landkreis;65 bis unter 75 Jahre;23923;11352;12571
08216;      Rastatt, Landkreis;75 Jahre und mehr;22254;8755;13499
08216;      Rastatt, Landkreis;Insgesamt;226902;111743;115159
08221;      Heidelberg, Kreisfreie Stadt;unter 3 Jahre;3700;1879;1821
08221;      Heidelberg, Kreisfreie Stadt;3 bis unter 6 Jahre;3416;1758;1658
08221;      Heidelberg, Kreisfreie Stadt;6 bis unter 10 Jahre;4059;2063;1996
08221;      Heidelberg, Kreisfreie Stadt;10 bis unter 15 Jahre;5114;2633;2481
08221;      Heidelberg, Kreisfreie Stadt;15 bis unter 18 Jahre;3191;1616;1575
08221;      Heidelberg, Kreisfreie Stadt;18 bis unter 20 Jahre;3396;1684;1712
08221;      Heidelberg, Kreisfreie Stadt;20 bis unter 25 Jahre;15301;6454;8847
08221;      Heidelberg, Kreisfreie Stadt;25 bis unter 30 Jahre;14989;6910;8079
08221;      Heidelberg, Kreisfreie Stadt;30 bis unter 35 Jahre;12019;5911;6108
08221;      Heidelberg, Kreisfreie Stadt;35 bis unter 40 Jahre;9590;4748;4842
08221;      Heidelberg, Kreisfreie Stadt;40 bis unter 45 Jahre;11261;5586;5675
08221;      Heidelberg, Kreisfreie Stadt;45 bis unter 50 Jahre;12889;6424;6465
08221;      Heidelberg, Kreisfreie Stadt;50 bis unter 55 Jahre;10629;5321;5308
08221;      Heidelberg, Kreisfreie Stadt;55 bis unter 60 Jahre;8541;4269;4272
08221;      Heidelberg, Kreisfreie Stadt;60 bis unter 65 Jahre;7334;3540;3794
08221;      Heidelberg, Kreisfreie Stadt;65 bis unter 75 Jahre;12720;6013;6707
08221;      Heidelberg, Kreisfreie Stadt;75 Jahre und mehr;11484;4182;7302
08221;      Heidelberg, Kreisfreie Stadt;Insgesamt;149633;70991;78642
08222;      Mannheim, Universitätsstadt, Kreisfreie Stadt;unter 3 Jahre;7901;3969;3932
08222;      Mannheim, Universitätsstadt, Kreisfreie Stadt;3 bis unter 6 Jahre;7646;3923;3723
08222;      Mannheim, Universitätsstadt, Kreisfreie Stadt;6 bis unter 10 Jahre;9797;4988;4809
08222;      Mannheim, Universitätsstadt, Kreisfreie Stadt;10 bis unter 15 Jahre;13032;6547;6485
08222;      Mannheim, Universitätsstadt, Kreisfreie Stadt;15 bis unter 18 Jahre;8166;4181;3985
08222;      Mannheim, Universitätsstadt, Kreisfreie Stadt;18 bis unter 20 Jahre;6329;3230;3099
08222;      Mannheim, Universitätsstadt, Kreisfreie Stadt;20 bis unter 25 Jahre;22387;11148;11239
08222;      Mannheim, Universitätsstadt, Kreisfreie Stadt;25 bis unter 30 Jahre;23726;12010;11716
08222;      Mannheim, Universitätsstadt, Kreisfreie Stadt;30 bis unter 35 Jahre;22875;11744;11131
08222;      Mannheim, Universitätsstadt, Kreisfreie Stadt;35 bis unter 40 Jahre;20124;10455;9669
08222;      Mannheim, Universitätsstadt, Kreisfreie Stadt;40 bis unter 45 Jahre;23961;12653;11308
08222;      Mannheim, Universitätsstadt, Kreisfreie Stadt;45 bis unter 50 Jahre;27884;14535;13349
08222;      Mannheim, Universitätsstadt, Kreisfreie Stadt;50 bis unter 55 Jahre;23862;12532;11330
08222;      Mannheim, Universitätsstadt, Kreisfreie Stadt;55 bis unter 60 Jahre;19525;9938;9587
08222;      Mannheim, Universitätsstadt, Kreisfreie Stadt;60 bis unter 65 Jahre;17731;8694;9037
08222;      Mannheim, Universitätsstadt, Kreisfreie Stadt;65 bis unter 75 Jahre;31632;15333;16299
08222;      Mannheim, Universitätsstadt, Kreisfreie Stadt;75 Jahre und mehr;28353;11010;17343
08222;      Mannheim, Universitätsstadt, Kreisfreie Stadt;Insgesamt;314931;156890;158041
08225;      Neckar-Odenwald-Kreis;unter 3 Jahre;3319;1717;1602
08225;      Neckar-Odenwald-Kreis;3 bis unter 6 Jahre;3492;1763;1729
08225;      Neckar-Odenwald-Kreis;6 bis unter 10 Jahre;5485;2872;2613
08225;      Neckar-Odenwald-Kreis;10 bis unter 15 Jahre;7791;4084;3707
08225;      Neckar-Odenwald-Kreis;15 bis unter 18 Jahre;5012;2612;2400
08225;      Neckar-Odenwald-Kreis;18 bis unter 20 Jahre;3513;1832;1681
08225;      Neckar-Odenwald-Kreis;20 bis unter 25 Jahre;8468;4509;3959
08225;      Neckar-Odenwald-Kreis;25 bis unter 30 Jahre;7859;4165;3694
08225;      Neckar-Odenwald-Kreis;30 bis unter 35 Jahre;7747;3893;3854
08225;      Neckar-Odenwald-Kreis;35 bis unter 40 Jahre;8233;4104;4129
08225;      Neckar-Odenwald-Kreis;40 bis unter 45 Jahre;11535;5995;5540
08225;      Neckar-Odenwald-Kreis;45 bis unter 50 Jahre;13425;7081;6344
08225;      Neckar-Odenwald-Kreis;50 bis unter 55 Jahre;12144;6201;5943
08225;      Neckar-Odenwald-Kreis;55 bis unter 60 Jahre;10221;5155;5066
08225;      Neckar-Odenwald-Kreis;60 bis unter 65 Jahre;9027;4551;4476
08225;      Neckar-Odenwald-Kreis;65 bis unter 75 Jahre;14962;7284;7678
08225;      Neckar-Odenwald-Kreis;75 Jahre und mehr;13925;5374;8551
08225;      Neckar-Odenwald-Kreis;Insgesamt;146158;73192;72966
08226;      Rhein-Neckar-Kreis;unter 3 Jahre;13556;6969;6587
08226;      Rhein-Neckar-Kreis;3 bis unter 6 Jahre;13940;7202;6738
08226;      Rhein-Neckar-Kreis;6 bis unter 10 Jahre;19269;9919;9350
08226;      Rhein-Neckar-Kreis;10 bis unter 15 Jahre;27112;13862;13250
08226;      Rhein-Neckar-Kreis;15 bis unter 18 Jahre;17009;8576;8433
08226;      Rhein-Neckar-Kreis;18 bis unter 20 Jahre;11611;5934;5677
08226;      Rhein-Neckar-Kreis;20 bis unter 25 Jahre;30068;15521;14547
08226;      Rhein-Neckar-Kreis;25 bis unter 30 Jahre;30133;15008;15125
08226;      Rhein-Neckar-Kreis;30 bis unter 35 Jahre;30947;15134;15813
08226;      Rhein-Neckar-Kreis;35 bis unter 40 Jahre;31400;15414;15986
08226;      Rhein-Neckar-Kreis;40 bis unter 45 Jahre;44316;22367;21949
08226;      Rhein-Neckar-Kreis;45 bis unter 50 Jahre;48784;24624;24160
08226;      Rhein-Neckar-Kreis;50 bis unter 55 Jahre;43360;21625;21735
08226;      Rhein-Neckar-Kreis;55 bis unter 60 Jahre;35898;17615;18283
08226;      Rhein-Neckar-Kreis;60 bis unter 65 Jahre;33419;16306;17113
08226;      Rhein-Neckar-Kreis;65 bis unter 75 Jahre;58644;27982;30662
08226;      Rhein-Neckar-Kreis;75 Jahre und mehr;49666;19692;29974
08226;      Rhein-Neckar-Kreis;Insgesamt;539132;263750;275382
08231;      Pforzheim, Kreisfreie Stadt;unter 3 Jahre;3201;1661;1540
08231;      Pforzheim, Kreisfreie Stadt;3 bis unter 6 Jahre;3208;1631;1577
08231;      Pforzheim, Kreisfreie Stadt;6 bis unter 10 Jahre;4327;2232;2095
08231;      Pforzheim, Kreisfreie Stadt;10 bis unter 15 Jahre;5835;2972;2863
08231;      Pforzheim, Kreisfreie Stadt;15 bis unter 18 Jahre;3660;1859;1801
08231;      Pforzheim, Kreisfreie Stadt;18 bis unter 20 Jahre;2597;1315;1282
08231;      Pforzheim, Kreisfreie Stadt;20 bis unter 25 Jahre;7952;4110;3842
08231;      Pforzheim, Kreisfreie Stadt;25 bis unter 30 Jahre;8007;4122;3885
08231;      Pforzheim, Kreisfreie Stadt;30 bis unter 35 Jahre;7671;3913;3758
08231;      Pforzheim, Kreisfreie Stadt;35 bis unter 40 Jahre;6909;3464;3445
08231;      Pforzheim, Kreisfreie Stadt;40 bis unter 45 Jahre;8776;4537;4239
08231;      Pforzheim, Kreisfreie Stadt;45 bis unter 50 Jahre;9913;5064;4849
08231;      Pforzheim, Kreisfreie Stadt;50 bis unter 55 Jahre;9043;4617;4426
08231;      Pforzheim, Kreisfreie Stadt;55 bis unter 60 Jahre;7679;3712;3967
08231;      Pforzheim, Kreisfreie Stadt;60 bis unter 65 Jahre;6896;3245;3651
08231;      Pforzheim, Kreisfreie Stadt;65 bis unter 75 Jahre;12554;5709;6845
08231;      Pforzheim, Kreisfreie Stadt;75 Jahre und mehr;12481;4483;7998
08231;      Pforzheim, Kreisfreie Stadt;Insgesamt;120709;58646;62063
08235;      Calw, Landkreis;unter 3 Jahre;3721;1911;1810
08235;      Calw, Landkreis;3 bis unter 6 Jahre;4020;2085;1935
08235;      Calw, Landkreis;6 bis unter 10 Jahre;6027;3103;2924
08235;      Calw, Landkreis;10 bis unter 15 Jahre;8851;4552;4299
08235;      Calw, Landkreis;15 bis unter 18 Jahre;5589;2860;2729
08235;      Calw, Landkreis;18 bis unter 20 Jahre;3832;2027;1805
08235;      Calw, Landkreis;20 bis unter 25 Jahre;9089;4749;4340
08235;      Calw, Landkreis;25 bis unter 30 Jahre;8221;4272;3949
08235;      Calw, Landkreis;30 bis unter 35 Jahre;8388;4214;4174
08235;      Calw, Landkreis;35 bis unter 40 Jahre;9076;4480;4596
08235;      Calw, Landkreis;40 bis unter 45 Jahre;12181;6123;6058
08235;      Calw, Landkreis;45 bis unter 50 Jahre;14424;7380;7044
08235;      Calw, Landkreis;50 bis unter 55 Jahre;12693;6434;6259
08235;      Calw, Landkreis;55 bis unter 60 Jahre;10715;5301;5414
08235;      Calw, Landkreis;60 bis unter 65 Jahre;9169;4558;4611
08235;      Calw, Landkreis;65 bis unter 75 Jahre;16159;7781;8378
08235;      Calw, Landkreis;75 Jahre und mehr;14764;5850;8914
08235;      Calw, Landkreis;Insgesamt;156919;77680;79239
08236;      Enzkreis;unter 3 Jahre;4455;2304;2151
08236;      Enzkreis;3 bis unter 6 Jahre;4844;2487;2357
08236;      Enzkreis;6 bis unter 10 Jahre;7405;3781;3624
08236;      Enzkreis;10 bis unter 15 Jahre;11169;5706;5463
08236;      Enzkreis;15 bis unter 18 Jahre;6952;3586;3366
08236;      Enzkreis;18 bis unter 20 Jahre;4862;2555;2307
08236;      Enzkreis;20 bis unter 25 Jahre;10859;5792;5067
08236;      Enzkreis;25 bis unter 30 Jahre;9793;5040;4753
08236;      Enzkreis;30 bis unter 35 Jahre;10128;5072;5056
08236;      Enzkreis;35 bis unter 40 Jahre;10849;5405;5444
08236;      Enzkreis;40 bis unter 45 Jahre;15675;7717;7958
08236;      Enzkreis;45 bis unter 50 Jahre;17682;8981;8701
08236;      Enzkreis;50 bis unter 55 Jahre;15876;8062;7814
08236;      Enzkreis;55 bis unter 60 Jahre;13137;6567;6570
08236;      Enzkreis;60 bis unter 65 Jahre;11298;5572;5726
08236;      Enzkreis;65 bis unter 75 Jahre;20959;10156;10803
08236;      Enzkreis;75 Jahre und mehr;17975;7074;10901
08236;      Enzkreis;Insgesamt;193918;95857;98061
08237;      Freudenstadt, Landkreis;unter 3 Jahre;2843;1443;1400
08237;      Freudenstadt, Landkreis;3 bis unter 6 Jahre;3059;1582;1477
08237;      Freudenstadt, Landkreis;6 bis unter 10 Jahre;4576;2403;2173
08237;      Freudenstadt, Landkreis;10 bis unter 15 Jahre;6581;3404;3177
08237;      Freudenstadt, Landkreis;15 bis unter 18 Jahre;4279;2263;2016
08237;      Freudenstadt, Landkreis;18 bis unter 20 Jahre;2991;1511;1480
08237;      Freudenstadt, Landkreis;20 bis unter 25 Jahre;7075;3695;3380
08237;      Freudenstadt, Landkreis;25 bis unter 30 Jahre;6532;3262;3270
08237;      Freudenstadt, Landkreis;30 bis unter 35 Jahre;6454;3259;3195
08237;      Freudenstadt, Landkreis;35 bis unter 40 Jahre;6988;3433;3555
08237;      Freudenstadt, Landkreis;40 bis unter 45 Jahre;9568;4792;4776
08237;      Freudenstadt, Landkreis;45 bis unter 50 Jahre;10537;5241;5296
08237;      Freudenstadt, Landkreis;50 bis unter 55 Jahre;9478;4845;4633
08237;      Freudenstadt, Landkreis;55 bis unter 60 Jahre;8060;4133;3927
08237;      Freudenstadt, Landkreis;60 bis unter 65 Jahre;6747;3457;3290
08237;      Freudenstadt, Landkreis;65 bis unter 75 Jahre;11746;5562;6184
08237;      Freudenstadt, Landkreis;75 Jahre und mehr;11165;4205;6960
08237;      Freudenstadt, Landkreis;Insgesamt;118679;58490;60189
083;    Freiburg, Regierungsbezirk;unter 3 Jahre;55576;28493;27083
083;    Freiburg, Regierungsbezirk;3 bis unter 6 Jahre;58061;29555;28506
083;    Freiburg, Regierungsbezirk;6 bis unter 10 Jahre;81067;41747;39320
083;    Freiburg, Regierungsbezirk;10 bis unter 15 Jahre;116243;59603;56640
083;    Freiburg, Regierungsbezirk;15 bis unter 18 Jahre;73197;37736;35461
083;    Freiburg, Regierungsbezirk;18 bis unter 20 Jahre;51598;26369;25229
083;    Freiburg, Regierungsbezirk;20 bis unter 25 Jahre;140780;70784;69996
083;    Freiburg, Regierungsbezirk;25 bis unter 30 Jahre;132427;66706;65721
083;    Freiburg, Regierungsbezirk;30 bis unter 35 Jahre;126547;62797;63750
083;    Freiburg, Regierungsbezirk;35 bis unter 40 Jahre;127202;63025;64177
083;    Freiburg, Regierungsbezirk;40 bis unter 45 Jahre;172096;86127;85969
083;    Freiburg, Regierungsbezirk;45 bis unter 50 Jahre;193826;98256;95570
083;    Freiburg, Regierungsbezirk;50 bis unter 55 Jahre;173552;87378;86174
083;    Freiburg, Regierungsbezirk;55 bis unter 60 Jahre;145843;72448;73395
083;    Freiburg, Regierungsbezirk;60 bis unter 65 Jahre;124930;61673;63257
083;    Freiburg, Regierungsbezirk;65 bis unter 75 Jahre;226048;106785;119263
083;    Freiburg, Regierungsbezirk;75 Jahre und mehr;208113;81449;126664
083;    Freiburg, Regierungsbezirk;Insgesamt;2207106;1080931;1126175
08311;      Freiburg im Breisgau, Kreisfreie Stadt;unter 3 Jahre;6348;3284;3064
08311;      Freiburg im Breisgau, Kreisfreie Stadt;3 bis unter 6 Jahre;5708;2886;2822
08311;      Freiburg im Breisgau, Kreisfreie Stadt;6 bis unter 10 Jahre;7205;3680;3525
08311;      Freiburg im Breisgau, Kreisfreie Stadt;10 bis unter 15 Jahre;9262;4836;4426
08311;      Freiburg im Breisgau, Kreisfreie Stadt;15 bis unter 18 Jahre;5374;2759;2615
08311;      Freiburg im Breisgau, Kreisfreie Stadt;18 bis unter 20 Jahre;4716;2163;2553
08311;      Freiburg im Breisgau, Kreisfreie Stadt;20 bis unter 25 Jahre;21697;9173;12524
08311;      Freiburg im Breisgau, Kreisfreie Stadt;25 bis unter 30 Jahre;21143;10108;11035
08311;      Freiburg im Breisgau, Kreisfreie Stadt;30 bis unter 35 Jahre;17602;8766;8836
08311;      Freiburg im Breisgau, Kreisfreie Stadt;35 bis unter 40 Jahre;14982;7498;7484
08311;      Freiburg im Breisgau, Kreisfreie Stadt;40 bis unter 45 Jahre;17625;8764;8861
08311;      Freiburg im Breisgau, Kreisfreie Stadt;45 bis unter 50 Jahre;20036;10167;9869
08311;      Freiburg im Breisgau, Kreisfreie Stadt;50 bis unter 55 Jahre;17130;8662;8468
08311;      Freiburg im Breisgau, Kreisfreie Stadt;55 bis unter 60 Jahre;13342;6637;6705
08311;      Freiburg im Breisgau, Kreisfreie Stadt;60 bis unter 65 Jahre;10544;5137;5407
08311;      Freiburg im Breisgau, Kreisfreie Stadt;65 bis unter 75 Jahre;18744;8480;10264
08311;      Freiburg im Breisgau, Kreisfreie Stadt;75 Jahre und mehr;17686;6357;11329
08311;      Freiburg im Breisgau, Kreisfreie Stadt;Insgesamt;229144;109357;119787
08315;      Breisgau-Hochschwarzwald, Landkreis;unter 3 Jahre;6442;3318;3124
08315;      Breisgau-Hochschwarzwald, Landkreis;3 bis unter 6 Jahre;6731;3418;3313
08315;      Breisgau-Hochschwarzwald, Landkreis;6 bis unter 10 Jahre;9643;5040;4603
08315;      Breisgau-Hochschwarzwald, Landkreis;10 bis unter 15 Jahre;13723;7080;6643
08315;      Breisgau-Hochschwarzwald, Landkreis;15 bis unter 18 Jahre;8785;4634;4151
08315;      Breisgau-Hochschwarzwald, Landkreis;18 bis unter 20 Jahre;6005;3129;2876
08315;      Breisgau-Hochschwarzwald, Landkreis;20 bis unter 25 Jahre;14181;7283;6898
08315;      Breisgau-Hochschwarzwald, Landkreis;25 bis unter 30 Jahre;13160;6568;6592
08315;      Breisgau-Hochschwarzwald, Landkreis;30 bis unter 35 Jahre;13447;6671;6776
08315;      Breisgau-Hochschwarzwald, Landkreis;35 bis unter 40 Jahre;14128;6752;7376
08315;      Breisgau-Hochschwarzwald, Landkreis;40 bis unter 45 Jahre;20072;9911;10161
08315;      Breisgau-Hochschwarzwald, Landkreis;45 bis unter 50 Jahre;22459;11214;11245
08315;      Breisgau-Hochschwarzwald, Landkreis;50 bis unter 55 Jahre;19848;9915;9933
08315;      Breisgau-Hochschwarzwald, Landkreis;55 bis unter 60 Jahre;17351;8501;8850
08315;      Breisgau-Hochschwarzwald, Landkreis;60 bis unter 65 Jahre;15263;7444;7819
08315;      Breisgau-Hochschwarzwald, Landkreis;65 bis unter 75 Jahre;27458;13123;14335
08315;      Breisgau-Hochschwarzwald, Landkreis;75 Jahre und mehr;23631;9565;14066
08315;      Breisgau-Hochschwarzwald, Landkreis;Insgesamt;252327;123566;128761
08316;      Emmendingen, Landkreis;unter 3 Jahre;3942;2033;1909
08316;      Emmendingen, Landkreis;3 bis unter 6 Jahre;4245;2169;2076
08316;      Emmendingen, Landkreis;6 bis unter 10 Jahre;6086;3218;2868
08316;      Emmendingen, Landkreis;10 bis unter 15 Jahre;8791;4456;4335
08316;      Emmendingen, Landkreis;15 bis unter 18 Jahre;5586;2836;2750
08316;      Emmendingen, Landkreis;18 bis unter 20 Jahre;3735;1914;1821
08316;      Emmendingen, Landkreis;20 bis unter 25 Jahre;9009;4711;4298
08316;      Emmendingen, Landkreis;25 bis unter 30 Jahre;8497;4375;4122
08316;      Emmendingen, Landkreis;30 bis unter 35 Jahre;8588;4242;4346
08316;      Emmendingen, Landkreis;35 bis unter 40 Jahre;9117;4466;4651
08316;      Emmendingen, Landkreis;40 bis unter 45 Jahre;12725;6399;6326
08316;      Emmendingen, Landkreis;45 bis unter 50 Jahre;14275;7203;7072
08316;      Emmendingen, Landkreis;50 bis unter 55 Jahre;12913;6415;6498
08316;      Emmendingen, Landkreis;55 bis unter 60 Jahre;11191;5576;5615
08316;      Emmendingen, Landkreis;60 bis unter 65 Jahre;9180;4533;4647
08316;      Emmendingen, Landkreis;65 bis unter 75 Jahre;16606;7850;8756
08316;      Emmendingen, Landkreis;75 Jahre und mehr;14269;5647;8622
08316;      Emmendingen, Landkreis;Insgesamt;158755;78043;80712
08317;      Ortenaukreis;unter 3 Jahre;10395;5331;5064
08317;      Ortenaukreis;3 bis unter 6 Jahre;11228;5722;5506
08317;      Ortenaukreis;6 bis unter 10 Jahre;15778;8108;7670
08317;      Ortenaukreis;10 bis unter 15 Jahre;22797;11770;11027
08317;      Ortenaukreis;15 bis unter 18 Jahre;14587;7476;7111
08317;      Ortenaukreis;18 bis unter 20 Jahre;10006;5128;4878
08317;      Ortenaukreis;20 bis unter 25 Jahre;24925;13164;11761
08317;      Ortenaukreis;25 bis unter 30 Jahre;23542;12164;11378
08317;      Ortenaukreis;30 bis unter 35 Jahre;22855;11413;11442
08317;      Ortenaukreis;35 bis unter 40 Jahre;23843;11891;11952
08317;      Ortenaukreis;40 bis unter 45 Jahre;32838;16528;16310
08317;      Ortenaukreis;45 bis unter 50 Jahre;36525;18622;17903
08317;      Ortenaukreis;50 bis unter 55 Jahre;33206;16843;16363
08317;      Ortenaukreis;55 bis unter 60 Jahre;28794;14449;14345
08317;      Ortenaukreis;60 bis unter 65 Jahre;24323;12172;12151
08317;      Ortenaukreis;65 bis unter 75 Jahre;41770;19867;21903
08317;      Ortenaukreis;75 Jahre und mehr;40463;15617;24846
08317;      Ortenaukreis;Insgesamt;417875;206265;211610
08325;      Rottweil, Landkreis;unter 3 Jahre;3400;1772;1628
08325;      Rottweil, Landkreis;3 bis unter 6 Jahre;3714;1899;1815
08325;      Rottweil, Landkreis;6 bis unter 10 Jahre;5313;2664;2649
08325;      Rottweil, Landkreis;10 bis unter 15 Jahre;7941;4032;3909
08325;      Rottweil, Landkreis;15 bis unter 18 Jahre;5162;2605;2557
08325;      Rottweil, Landkreis;18 bis unter 20 Jahre;3481;1802;1679
08325;      Rottweil, Landkreis;20 bis unter 25 Jahre;8049;4231;3818
08325;      Rottweil, Landkreis;25 bis unter 30 Jahre;7374;3756;3618
08325;      Rottweil, Landkreis;30 bis unter 35 Jahre;7546;3805;3741
08325;      Rottweil, Landkreis;35 bis unter 40 Jahre;7903;4008;3895
08325;      Rottweil, Landkreis;40 bis unter 45 Jahre;10894;5586;5308
08325;      Rottweil, Landkreis;45 bis unter 50 Jahre;12067;6198;5869
08325;      Rottweil, Landkreis;50 bis unter 55 Jahre;10856;5515;5341
08325;      Rottweil, Landkreis;55 bis unter 60 Jahre;8962;4509;4453
08325;      Rottweil, Landkreis;60 bis unter 65 Jahre;7884;3932;3952
08325;      Rottweil, Landkreis;65 bis unter 75 Jahre;14877;7111;7766
08325;      Rottweil, Landkreis;75 Jahre und mehr;13296;5095;8201
08325;      Rottweil, Landkreis;Insgesamt;138719;68520;70199
08326;      Schwarzwald-Baar-Kreis;unter 3 Jahre;5039;2539;2500
08326;      Schwarzwald-Baar-Kreis;3 bis unter 6 Jahre;5230;2633;2597
08326;      Schwarzwald-Baar-Kreis;6 bis unter 10 Jahre;7459;3786;3673
08326;      Schwarzwald-Baar-Kreis;10 bis unter 15 Jahre;10709;5562;5147
08326;      Schwarzwald-Baar-Kreis;15 bis unter 18 Jahre;6957;3657;3300
08326;      Schwarzwald-Baar-Kreis;18 bis unter 20 Jahre;4793;2459;2334
08326;      Schwarzwald-Baar-Kreis;20 bis unter 25 Jahre;12360;6527;5833
08326;      Schwarzwald-Baar-Kreis;25 bis unter 30 Jahre;11869;6175;5694
08326;      Schwarzwald-Baar-Kreis;30 bis unter 35 Jahre;11369;5769;5600
08326;      Schwarzwald-Baar-Kreis;35 bis unter 40 Jahre;11215;5674;5541
08326;      Schwarzwald-Baar-Kreis;40 bis unter 45 Jahre;15048;7478;7570
08326;      Schwarzwald-Baar-Kreis;45 bis unter 50 Jahre;17050;8675;8375
08326;      Schwarzwald-Baar-Kreis;50 bis unter 55 Jahre;15999;8013;7986
08326;      Schwarzwald-Baar-Kreis;55 bis unter 60 Jahre;13806;6794;7012
08326;      Schwarzwald-Baar-Kreis;60 bis unter 65 Jahre;12383;6034;6349
08326;      Schwarzwald-Baar-Kreis;65 bis unter 75 Jahre;22885;10705;12180
08326;      Schwarzwald-Baar-Kreis;75 Jahre und mehr;22043;8731;13312
08326;      Schwarzwald-Baar-Kreis;Insgesamt;206214;101211;105003
08327;      Tuttlingen, Landkreis;unter 3 Jahre;3573;1826;1747
08327;      Tuttlingen, Landkreis;3 bis unter 6 Jahre;3931;1997;1934
08327;      Tuttlingen, Landkreis;6 bis unter 10 Jahre;5473;2811;2662
08327;      Tuttlingen, Landkreis;10 bis unter 15 Jahre;7735;3994;3741
08327;      Tuttlingen, Landkreis;15 bis unter 18 Jahre;4757;2430;2327
08327;      Tuttlingen, Landkreis;18 bis unter 20 Jahre;3242;1712;1530
08327;      Tuttlingen, Landkreis;20 bis unter 25 Jahre;8185;4244;3941
08327;      Tuttlingen, Landkreis;25 bis unter 30 Jahre;7922;4141;3781
08327;      Tuttlingen, Landkreis;30 bis unter 35 Jahre;7799;3880;3919
08327;      Tuttlingen, Landkreis;35 bis unter 40 Jahre;8050;4109;3941
08327;      Tuttlingen, Landkreis;40 bis unter 45 Jahre;10074;5139;4935
08327;      Tuttlingen, Landkreis;45 bis unter 50 Jahre;11083;5789;5294
08327;      Tuttlingen, Landkreis;50 bis unter 55 Jahre;10286;5110;5176
08327;      Tuttlingen, Landkreis;55 bis unter 60 Jahre;8812;4416;4396
08327;      Tuttlingen, Landkreis;60 bis unter 65 Jahre;7316;3653;3663
08327;      Tuttlingen, Landkreis;65 bis unter 75 Jahre;13425;6396;7029
08327;      Tuttlingen, Landkreis;75 Jahre und mehr;12541;5015;7526
08327;      Tuttlingen, Landkreis;Insgesamt;134204;66662;67542
08335;      Konstanz, Landkreis;unter 3 Jahre;6600;3376;3224
08335;      Konstanz, Landkreis;3 bis unter 6 Jahre;6859;3509;3350
08335;      Konstanz, Landkreis;6 bis unter 10 Jahre;9572;4889;4683
08335;      Konstanz, Landkreis;10 bis unter 15 Jahre;13814;6994;6820
08335;      Konstanz, Landkreis;15 bis unter 18 Jahre;8410;4322;4088
08335;      Konstanz, Landkreis;18 bis unter 20 Jahre;6341;3205;3136
08335;      Konstanz, Landkreis;20 bis unter 25 Jahre;20166;10022;10144
08335;      Konstanz, Landkreis;25 bis unter 30 Jahre;17393;8634;8759
08335;      Konstanz, Landkreis;30 bis unter 35 Jahre;15866;7863;8003
08335;      Konstanz, Landkreis;35 bis unter 40 Jahre;15783;7743;8040
08335;      Konstanz, Landkreis;40 bis unter 45 Jahre;22051;10977;11074
08335;      Konstanz, Landkreis;45 bis unter 50 Jahre;25599;12945;12654
08335;      Konstanz, Landkreis;50 bis unter 55 Jahre;21943;11183;10760
08335;      Konstanz, Landkreis;55 bis unter 60 Jahre;17608;8640;8968
08335;      Konstanz, Landkreis;60 bis unter 65 Jahre;15742;7723;8019
08335;      Konstanz, Landkreis;65 bis unter 75 Jahre;29955;14132;15823
08335;      Konstanz, Landkreis;75 Jahre und mehr;26846;10543;16303
08335;      Konstanz, Landkreis;Insgesamt;280548;136700;143848
08336;      Lörrach, Landkreis;unter 3 Jahre;5681;2919;2762
08336;      Lörrach, Landkreis;3 bis unter 6 Jahre;5858;3009;2849
08336;      Lörrach, Landkreis;6 bis unter 10 Jahre;8122;4207;3915
08336;      Lörrach, Landkreis;10 bis unter 15 Jahre;12193;6148;6045
08336;      Lörrach, Landkreis;15 bis unter 18 Jahre;7664;3969;3695
08336;      Lörrach, Landkreis;18 bis unter 20 Jahre;5360;2783;2577
08336;      Lörrach, Landkreis;20 bis unter 25 Jahre;12627;6445;6182
08336;      Lörrach, Landkreis;25 bis unter 30 Jahre;12379;6161;6218
08336;      Lörrach, Landkreis;30 bis unter 35 Jahre;12524;6033;6491
08336;      Lörrach, Landkreis;35 bis unter 40 Jahre;12950;6359;6591
08336;      Lörrach, Landkreis;40 bis unter 45 Jahre;18017;9003;9014
08336;      Lörrach, Landkreis;45 bis unter 50 Jahre;20177;10096;10081
08336;      Lörrach, Landkreis;50 bis unter 55 Jahre;18352;9128;9224
08336;      Lörrach, Landkreis;55 bis unter 60 Jahre;14707;7395;7312
08336;      Lörrach, Landkreis;60 bis unter 65 Jahre;12594;6157;6437
08336;      Lörrach, Landkreis;65 bis unter 75 Jahre;22990;10834;12156
08336;      Lörrach, Landkreis;75 Jahre und mehr;21091;8422;12669
08336;      Lörrach, Landkreis;Insgesamt;223286;109068;114218
08337;      Waldshut, Landkreis;unter 3 Jahre;4156;2095;2061
08337;      Waldshut, Landkreis;3 bis unter 6 Jahre;4557;2313;2244
08337;      Waldshut, Landkreis;6 bis unter 10 Jahre;6416;3344;3072
08337;      Waldshut, Landkreis;10 bis unter 15 Jahre;9278;4731;4547
08337;      Waldshut, Landkreis;15 bis unter 18 Jahre;5915;3048;2867
08337;      Waldshut, Landkreis;18 bis unter 20 Jahre;3919;2074;1845
08337;      Waldshut, Landkreis;20 bis unter 25 Jahre;9581;4984;4597
08337;      Waldshut, Landkreis;25 bis unter 30 Jahre;9148;4624;4524
08337;      Waldshut, Landkreis;30 bis unter 35 Jahre;8951;4355;4596
08337;      Waldshut, Landkreis;35 bis unter 40 Jahre;9231;4525;4706
08337;      Waldshut, Landkreis;40 bis unter 45 Jahre;12752;6342;6410
08337;      Waldshut, Landkreis;45 bis unter 50 Jahre;14555;7347;7208
08337;      Waldshut, Landkreis;50 bis unter 55 Jahre;13019;6594;6425
08337;      Waldshut, Landkreis;55 bis unter 60 Jahre;11270;5531;5739
08337;      Waldshut, Landkreis;60 bis unter 65 Jahre;9701;4888;4813
08337;      Waldshut, Landkreis;65 bis unter 75 Jahre;17338;8287;9051
08337;      Waldshut, Landkreis;75 Jahre und mehr;16247;6457;9790
08337;      Waldshut, Landkreis;Insgesamt;166034;81539;84495
084;    Tübingen, Regierungsbezirk;unter 3 Jahre;46249;23721;22528
084;    Tübingen, Regierungsbezirk;3 bis unter 6 Jahre;48195;24593;23602
084;    Tübingen, Regierungsbezirk;6 bis unter 10 Jahre;68414;35274;33140
084;    Tübingen, Regierungsbezirk;10 bis unter 15 Jahre;98956;50678;48278
084;    Tübingen, Regierungsbezirk;15 bis unter 18 Jahre;61949;31908;30041
084;    Tübingen, Regierungsbezirk;18 bis unter 20 Jahre;44587;22888;21699
084;    Tübingen, Regierungsbezirk;20 bis unter 25 Jahre;116151;59068;57083
084;    Tübingen, Regierungsbezirk;25 bis unter 30 Jahre;109365;55552;53813
084;    Tübingen, Regierungsbezirk;30 bis unter 35 Jahre;106158;53348;52810
084;    Tübingen, Regierungsbezirk;35 bis unter 40 Jahre;108204;54417;53787
084;    Tübingen, Regierungsbezirk;40 bis unter 45 Jahre;142250;72281;69969
084;    Tübingen, Regierungsbezirk;45 bis unter 50 Jahre;159755;81821;77934
084;    Tübingen, Regierungsbezirk;50 bis unter 55 Jahre;141341;71630;69711
084;    Tübingen, Regierungsbezirk;55 bis unter 60 Jahre;117794;58719;59075
084;    Tübingen, Regierungsbezirk;60 bis unter 65 Jahre;100789;50291;50498
084;    Tübingen, Regierungsbezirk;65 bis unter 75 Jahre;181520;87191;94329
084;    Tübingen, Regierungsbezirk;75 Jahre und mehr;159525;62303;97222
084;    Tübingen, Regierungsbezirk;Insgesamt;1811202;895683;915519
08415;      Reutlingen, Landkreis;unter 3 Jahre;7032;3633;3399
08415;      Reutlingen, Landkreis;3 bis unter 6 Jahre;7425;3795;3630
08415;      Reutlingen, Landkreis;6 bis unter 10 Jahre;10621;5530;5091
08415;      Reutlingen, Landkreis;10 bis unter 15 Jahre;15092;7757;7335
08415;      Reutlingen, Landkreis;15 bis unter 18 Jahre;9494;4917;4577
08415;      Reutlingen, Landkreis;18 bis unter 20 Jahre;6674;3425;3249
08415;      Reutlingen, Landkreis;20 bis unter 25 Jahre;17045;8562;8483
08415;      Reutlingen, Landkreis;25 bis unter 30 Jahre;15959;8086;7873
08415;      Reutlingen, Landkreis;30 bis unter 35 Jahre;16060;7948;8112
08415;      Reutlingen, Landkreis;35 bis unter 40 Jahre;16901;8481;8420
08415;      Reutlingen, Landkreis;40 bis unter 45 Jahre;22349;11261;11088
08415;      Reutlingen, Landkreis;45 bis unter 50 Jahre;25000;12719;12281
08415;      Reutlingen, Landkreis;50 bis unter 55 Jahre;21948;11121;10827
08415;      Reutlingen, Landkreis;55 bis unter 60 Jahre;18479;9176;9303
08415;      Reutlingen, Landkreis;60 bis unter 65 Jahre;15519;7612;7907
08415;      Reutlingen, Landkreis;65 bis unter 75 Jahre;29102;13749;15353
08415;      Reutlingen, Landkreis;75 Jahre und mehr;26317;10337;15980
08415;      Reutlingen, Landkreis;Insgesamt;281017;138109;142908
08416;      Tübingen, Landkreis;unter 3 Jahre;5583;2855;2728
08416;      Tübingen, Landkreis;3 bis unter 6 Jahre;5647;2881;2766
08416;      Tübingen, Landkreis;6 bis unter 10 Jahre;8060;4116;3944
08416;      Tübingen, Landkreis;10 bis unter 15 Jahre;11347;5811;5536
08416;      Tübingen, Landkreis;15 bis unter 18 Jahre;6901;3549;3352
08416;      Tübingen, Landkreis;18 bis unter 20 Jahre;5411;2707;2704
08416;      Tübingen, Landkreis;20 bis unter 25 Jahre;18610;8575;10035
08416;      Tübingen, Landkreis;25 bis unter 30 Jahre;16855;8258;8597
08416;      Tübingen, Landkreis;30 bis unter 35 Jahre;13655;6894;6761
08416;      Tübingen, Landkreis;35 bis unter 40 Jahre;12512;6161;6351
08416;      Tübingen, Landkreis;40 bis unter 45 Jahre;16468;8249;8219
08416;      Tübingen, Landkreis;45 bis unter 50 Jahre;21124;10716;10408
08416;      Tübingen, Landkreis;50 bis unter 55 Jahre;18784;9798;8986
08416;      Tübingen, Landkreis;55 bis unter 60 Jahre;14587;7389;7198
08416;      Tübingen, Landkreis;60 bis unter 65 Jahre;11312;5759;5553
08416;      Tübingen, Landkreis;65 bis unter 75 Jahre;18788;9126;9662
08416;      Tübingen, Landkreis;75 Jahre und mehr;16333;6225;10108
08416;      Tübingen, Landkreis;Insgesamt;221977;109069;112908
08417;      Zollernalbkreis;unter 3 Jahre;4406;2276;2130
08417;      Zollernalbkreis;3 bis unter 6 Jahre;4725;2398;2327
08417;      Zollernalbkreis;6 bis unter 10 Jahre;6695;3462;3233
08417;      Zollernalbkreis;10 bis unter 15 Jahre;9878;5105;4773
08417;      Zollernalbkreis;15 bis unter 18 Jahre;6535;3396;3139
08417;      Zollernalbkreis;18 bis unter 20 Jahre;4675;2429;2246
08417;      Zollernalbkreis;20 bis unter 25 Jahre;11091;5924;5167
08417;      Zollernalbkreis;25 bis unter 30 Jahre;10005;5201;4804
08417;      Zollernalbkreis;30 bis unter 35 Jahre;9861;4981;4880
08417;      Zollernalbkreis;35 bis unter 40 Jahre;10566;5353;5213
08417;      Zollernalbkreis;40 bis unter 45 Jahre;14275;7247;7028
08417;      Zollernalbkreis;45 bis unter 50 Jahre;16642;8494;8148
08417;      Zollernalbkreis;50 bis unter 55 Jahre;15231;7746;7485
08417;      Zollernalbkreis;55 bis unter 60 Jahre;12851;6374;6477
08417;      Zollernalbkreis;60 bis unter 65 Jahre;11170;5562;5608
08417;      Zollernalbkreis;65 bis unter 75 Jahre;20082;9502;10580
08417;      Zollernalbkreis;75 Jahre und mehr;19010;7293;11717
08417;      Zollernalbkreis;Insgesamt;187698;92743;94955
08421;      Ulm, Universitätsstadt, Kreisfreie Stadt;unter 3 Jahre;3371;1728;1643
08421;      Ulm, Universitätsstadt, Kreisfreie Stadt;3 bis unter 6 Jahre;3251;1625;1626
08421;      Ulm, Universitätsstadt, Kreisfreie Stadt;6 bis unter 10 Jahre;4052;2102;1950
08421;      Ulm, Universitätsstadt, Kreisfreie Stadt;10 bis unter 15 Jahre;5381;2770;2611
08421;      Ulm, Universitätsstadt, Kreisfreie Stadt;15 bis unter 18 Jahre;3249;1633;1616
08421;      Ulm, Universitätsstadt, Kreisfreie Stadt;18 bis unter 20 Jahre;2712;1348;1364
08421;      Ulm, Universitätsstadt, Kreisfreie Stadt;20 bis unter 25 Jahre;9197;4582;4615
08421;      Ulm, Universitätsstadt, Kreisfreie Stadt;25 bis unter 30 Jahre;9946;4952;4994
08421;      Ulm, Universitätsstadt, Kreisfreie Stadt;30 bis unter 35 Jahre;9473;4822;4651
08421;      Ulm, Universitätsstadt, Kreisfreie Stadt;35 bis unter 40 Jahre;8518;4409;4109
08421;      Ulm, Universitätsstadt, Kreisfreie Stadt;40 bis unter 45 Jahre;9284;4950;4334
08421;      Ulm, Universitätsstadt, Kreisfreie Stadt;45 bis unter 50 Jahre;9707;5106;4601
08421;      Ulm, Universitätsstadt, Kreisfreie Stadt;50 bis unter 55 Jahre;8579;4319;4260
08421;      Ulm, Universitätsstadt, Kreisfreie Stadt;55 bis unter 60 Jahre;7528;3615;3913
08421;      Ulm, Universitätsstadt, Kreisfreie Stadt;60 bis unter 65 Jahre;6618;3227;3391
08421;      Ulm, Universitätsstadt, Kreisfreie Stadt;65 bis unter 75 Jahre;12169;5794;6375
08421;      Ulm, Universitätsstadt, Kreisfreie Stadt;75 Jahre und mehr;10637;3983;6654
08421;      Ulm, Universitätsstadt, Kreisfreie Stadt;Insgesamt;123672;60965;62707
08425;      Alb-Donau-Kreis;unter 3 Jahre;4962;2529;2433
08425;      Alb-Donau-Kreis;3 bis unter 6 Jahre;5385;2778;2607
08425;      Alb-Donau-Kreis;6 bis unter 10 Jahre;7881;4071;3810
08425;      Alb-Donau-Kreis;10 bis unter 15 Jahre;11330;5778;5552
08425;      Alb-Donau-Kreis;15 bis unter 18 Jahre;6913;3541;3372
08425;      Alb-Donau-Kreis;18 bis unter 20 Jahre;4841;2534;2307
08425;      Alb-Donau-Kreis;20 bis unter 25 Jahre;11432;5948;5484
08425;      Alb-Donau-Kreis;25 bis unter 30 Jahre;10734;5636;5098
08425;      Alb-Donau-Kreis;30 bis unter 35 Jahre;11024;5623;5401
08425;      Alb-Donau-Kreis;35 bis unter 40 Jahre;11435;5736;5699
08425;      Alb-Donau-Kreis;40 bis unter 45 Jahre;14999;7722;7277
08425;      Alb-Donau-Kreis;45 bis unter 50 Jahre;16708;8708;8000
08425;      Alb-Donau-Kreis;50 bis unter 55 Jahre;14680;7444;7236
08425;      Alb-Donau-Kreis;55 bis unter 60 Jahre;12432;6372;6060
08425;      Alb-Donau-Kreis;60 bis unter 65 Jahre;10478;5327;5151
08425;      Alb-Donau-Kreis;65 bis unter 75 Jahre;18295;8842;9453
08425;      Alb-Donau-Kreis;75 Jahre und mehr;16296;6455;9841
08425;      Alb-Donau-Kreis;Insgesamt;189825;95044;94781
08426;      Biberach, Landkreis;unter 3 Jahre;5233;2658;2575
08426;      Biberach, Landkreis;3 bis unter 6 Jahre;5459;2811;2648
08426;      Biberach, Landkreis;6 bis unter 10 Jahre;7838;4029;3809
08426;      Biberach, Landkreis;10 bis unter 15 Jahre;11301;5746;5555
08426;      Biberach, Landkreis;15 bis unter 18 Jahre;7028;3578;3450
08426;      Biberach, Landkreis;18 bis unter 20 Jahre;4893;2492;2401
08426;      Biberach, Landkreis;20 bis unter 25 Jahre;11692;6201;5491
08426;      Biberach, Landkreis;25 bis unter 30 Jahre;11119;5734;5385
08426;      Biberach, Landkreis;30 bis unter 35 Jahre;10933;5489;5444
08426;      Biberach, Landkreis;35 bis unter 40 Jahre;11615;5870;5745
08426;      Biberach, Landkreis;40 bis unter 45 Jahre;15087;7677;7410
08426;      Biberach, Landkreis;45 bis unter 50 Jahre;16292;8411;7881
08426;      Biberach, Landkreis;50 bis unter 55 Jahre;14781;7517;7264
08426;      Biberach, Landkreis;55 bis unter 60 Jahre;12312;6290;6022
08426;      Biberach, Landkreis;60 bis unter 65 Jahre;10346;5283;5063
08426;      Biberach, Landkreis;65 bis unter 75 Jahre;17568;8560;9008
08426;      Biberach, Landkreis;75 Jahre und mehr;16026;6224;9802
08426;      Biberach, Landkreis;Insgesamt;189523;94570;94953
08435;      Bodenseekreis;unter 3 Jahre;5184;2690;2494
08435;      Bodenseekreis;3 bis unter 6 Jahre;5300;2673;2627
08435;      Bodenseekreis;6 bis unter 10 Jahre;7518;3880;3638
08435;      Bodenseekreis;10 bis unter 15 Jahre;11024;5688;5336
08435;      Bodenseekreis;15 bis unter 18 Jahre;7063;3603;3460
08435;      Bodenseekreis;18 bis unter 20 Jahre;4949;2566;2383
08435;      Bodenseekreis;20 bis unter 25 Jahre;11917;6159;5758
08435;      Bodenseekreis;25 bis unter 30 Jahre;11633;5972;5661
08435;      Bodenseekreis;30 bis unter 35 Jahre;12045;6039;6006
08435;      Bodenseekreis;35 bis unter 40 Jahre;12425;6249;6176
08435;      Bodenseekreis;40 bis unter 45 Jahre;16586;8327;8259
08435;      Bodenseekreis;45 bis unter 50 Jahre;17804;8914;8890
08435;      Bodenseekreis;50 bis unter 55 Jahre;15938;7995;7943
08435;      Bodenseekreis;55 bis unter 60 Jahre;13511;6481;7030
08435;      Bodenseekreis;60 bis unter 65 Jahre;12710;6202;6508
08435;      Bodenseekreis;65 bis unter 75 Jahre;24990;12001;12989
08435;      Bodenseekreis;75 Jahre und mehr;19136;7764;11372
08435;      Bodenseekreis;Insgesamt;209733;103203;106530
08436;      Ravensburg, Landkreis;unter 3 Jahre;7314;3728;3586
08436;      Ravensburg, Landkreis;3 bis unter 6 Jahre;7568;3877;3691
08436;      Ravensburg, Landkreis;6 bis unter 10 Jahre;10778;5507;5271
08436;      Ravensburg, Landkreis;10 bis unter 15 Jahre;15923;8152;7771
08436;      Ravensburg, Landkreis;15 bis unter 18 Jahre;9907;5195;4712
08436;      Ravensburg, Landkreis;18 bis unter 20 Jahre;6996;3635;3361
08436;      Ravensburg, Landkreis;20 bis unter 25 Jahre;17188;8843;8345
08436;      Ravensburg, Landkreis;25 bis unter 30 Jahre;15921;8069;7852
08436;      Ravensburg, Landkreis;30 bis unter 35 Jahre;16143;8042;8101
08436;      Ravensburg, Landkreis;35 bis unter 40 Jahre;16976;8532;8444
08436;      Ravensburg, Landkreis;40 bis unter 45 Jahre;22740;11450;11290
08436;      Ravensburg, Landkreis;45 bis unter 50 Jahre;24439;12445;11994
08436;      Ravensburg, Landkreis;50 bis unter 55 Jahre;21155;10493;10662
08436;      Ravensburg, Landkreis;55 bis unter 60 Jahre;17634;8798;8836
08436;      Ravensburg, Landkreis;60 bis unter 65 Jahre;15543;7748;7795
08436;      Ravensburg, Landkreis;65 bis unter 75 Jahre;27729;13571;14158
08436;      Ravensburg, Landkreis;75 Jahre und mehr;23955;9415;14540
08436;      Ravensburg, Landkreis;Insgesamt;277909;137500;140409
08437;      Sigmaringen, Landkreis;unter 3 Jahre;3164;1624;1540
08437;      Sigmaringen, Landkreis;3 bis unter 6 Jahre;3435;1755;1680
08437;      Sigmaringen, Landkreis;6 bis unter 10 Jahre;4971;2577;2394
08437;      Sigmaringen, Landkreis;10 bis unter 15 Jahre;7680;3871;3809
08437;      Sigmaringen, Landkreis;15 bis unter 18 Jahre;4859;2496;2363
08437;      Sigmaringen, Landkreis;18 bis unter 20 Jahre;3436;1752;1684
08437;      Sigmaringen, Landkreis;20 bis unter 25 Jahre;7979;4274;3705
08437;      Sigmaringen, Landkreis;25 bis unter 30 Jahre;7193;3644;3549
08437;      Sigmaringen, Landkreis;30 bis unter 35 Jahre;6964;3510;3454
08437;      Sigmaringen, Landkreis;35 bis unter 40 Jahre;7256;3626;3630
08437;      Sigmaringen, Landkreis;40 bis unter 45 Jahre;10462;5398;5064
08437;      Sigmaringen, Landkreis;45 bis unter 50 Jahre;12039;6308;5731
08437;      Sigmaringen, Landkreis;50 bis unter 55 Jahre;10245;5197;5048
08437;      Sigmaringen, Landkreis;55 bis unter 60 Jahre;8460;4224;4236
08437;      Sigmaringen, Landkreis;60 bis unter 65 Jahre;7093;3571;3522
08437;      Sigmaringen, Landkreis;65 bis unter 75 Jahre;12797;6046;6751
08437;      Sigmaringen, Landkreis;75 Jahre und mehr;11815;4607;7208
08437;      Sigmaringen, Landkreis;Insgesamt;129848;64480;65368
09;  Bayern;unter 3 Jahre;317762;163098;154664
09;  Bayern;3 bis unter 6 Jahre;325243;166659;158584
09;  Bayern;6 bis unter 10 Jahre;449945;230177;219768
09;  Bayern;10 bis unter 15 Jahre;626947;322382;304565
09;  Bayern;15 bis unter 18 Jahre;394012;202830;191182
09;  Bayern;18 bis unter 20 Jahre;282341;144720;137621
09;  Bayern;20 bis unter 25 Jahre;775709;397210;378499
09;  Bayern;25 bis unter 30 Jahre;778469;394241;384228
09;  Bayern;30 bis unter 35 Jahre;783158;394478;388680
09;  Bayern;35 bis unter 40 Jahre;770614;388804;381810
09;  Bayern;40 bis unter 45 Jahre;1006604;512577;494027
09;  Bayern;45 bis unter 50 Jahre;1097165;559634;537531
09;  Bayern;50 bis unter 55 Jahre;974938;493188;481750
09;  Bayern;55 bis unter 60 Jahre;810753;402525;408228
09;  Bayern;60 bis unter 65 Jahre;734264;360232;374032
09;  Bayern;65 bis unter 75 Jahre;1327506;630534;696972
09;  Bayern;75 Jahre und mehr;1140461;436367;704094
09;  Bayern;Insgesamt;12595891;6199656;6396235
091;    Oberbayern, Regierungsbezirk;unter 3 Jahre;122252;62911;59341
091;    Oberbayern, Regierungsbezirk;3 bis unter 6 Jahre;122215;62680;59535
091;    Oberbayern, Regierungsbezirk;6 bis unter 10 Jahre;161723;82719;79004
091;    Oberbayern, Regierungsbezirk;10 bis unter 15 Jahre;212852;109671;103181
091;    Oberbayern, Regierungsbezirk;15 bis unter 18 Jahre;129836;67007;62829
091;    Oberbayern, Regierungsbezirk;18 bis unter 20 Jahre;92179;47055;45124
091;    Oberbayern, Regierungsbezirk;20 bis unter 25 Jahre;268910;136373;132537
091;    Oberbayern, Regierungsbezirk;25 bis unter 30 Jahre;295347;147200;148147
091;    Oberbayern, Regierungsbezirk;30 bis unter 35 Jahre;308673;154309;154364
091;    Oberbayern, Regierungsbezirk;35 bis unter 40 Jahre;293088;148551;144537
091;    Oberbayern, Regierungsbezirk;40 bis unter 45 Jahre;367095;189353;177742
091;    Oberbayern, Regierungsbezirk;45 bis unter 50 Jahre;382574;196036;186538
091;    Oberbayern, Regierungsbezirk;50 bis unter 55 Jahre;321148;162054;159094
091;    Oberbayern, Regierungsbezirk;55 bis unter 60 Jahre;262277;128134;134143
091;    Oberbayern, Regierungsbezirk;60 bis unter 65 Jahre;248001;118434;129567
091;    Oberbayern, Regierungsbezirk;65 bis unter 75 Jahre;472839;223182;249657
091;    Oberbayern, Regierungsbezirk;75 Jahre und mehr;369697;143181;226516
091;    Oberbayern, Regierungsbezirk;Insgesamt;4430706;2178850;2251856
09161;      Ingolstadt;unter 3 Jahre;3526;1818;1708
09161;      Ingolstadt;3 bis unter 6 Jahre;3525;1842;1683
09161;      Ingolstadt;6 bis unter 10 Jahre;4642;2338;2304
09161;      Ingolstadt;10 bis unter 15 Jahre;6006;3202;2804
09161;      Ingolstadt;15 bis unter 18 Jahre;3629;1843;1786
09161;      Ingolstadt;18 bis unter 20 Jahre;2532;1297;1235
09161;      Ingolstadt;20 bis unter 25 Jahre;8024;4108;3916
09161;      Ingolstadt;25 bis unter 30 Jahre;9786;5121;4665
09161;      Ingolstadt;30 bis unter 35 Jahre;9703;5173;4530
09161;      Ingolstadt;35 bis unter 40 Jahre;8541;4513;4028
09161;      Ingolstadt;40 bis unter 45 Jahre;9701;5153;4548
09161;      Ingolstadt;45 bis unter 50 Jahre;9713;5142;4571
09161;      Ingolstadt;50 bis unter 55 Jahre;9085;4633;4452
09161;      Ingolstadt;55 bis unter 60 Jahre;7725;3746;3979
09161;      Ingolstadt;60 bis unter 65 Jahre;6790;3243;3547
09161;      Ingolstadt;65 bis unter 75 Jahre;12836;6130;6706
09161;      Ingolstadt;75 Jahre und mehr;10968;4217;6751
09161;      Ingolstadt;Insgesamt;126732;63519;63213
09162;      München, Landeshauptstadt;unter 3 Jahre;41925;21503;20422
09162;      München, Landeshauptstadt;3 bis unter 6 Jahre;37493;19131;18362
09162;      München, Landeshauptstadt;6 bis unter 10 Jahre;43809;22374;21435
09162;      München, Landeshauptstadt;10 bis unter 15 Jahre;51435;26407;25028
09162;      München, Landeshauptstadt;15 bis unter 18 Jahre;30140;15472;14668
09162;      München, Landeshauptstadt;18 bis unter 20 Jahre;23404;11813;11591
09162;      München, Landeshauptstadt;20 bis unter 25 Jahre;95328;45988;49340
09162;      München, Landeshauptstadt;25 bis unter 30 Jahre;125317;60572;64745
09162;      München, Landeshauptstadt;30 bis unter 35 Jahre;128784;64662;64122
09162;      München, Landeshauptstadt;35 bis unter 40 Jahre;106333;55523;50810
09162;      München, Landeshauptstadt;40 bis unter 45 Jahre;113214;61127;52087
09162;      München, Landeshauptstadt;45 bis unter 50 Jahre;107114;55919;51195
09162;      München, Landeshauptstadt;50 bis unter 55 Jahre;85884;42581;43303
09162;      München, Landeshauptstadt;55 bis unter 60 Jahre;73282;34279;39003
09162;      München, Landeshauptstadt;60 bis unter 65 Jahre;72074;33244;38830
09162;      München, Landeshauptstadt;65 bis unter 75 Jahre;138634;62657;75977
09162;      München, Landeshauptstadt;75 Jahre und mehr;104006;37688;66318
09162;      München, Landeshauptstadt;Insgesamt;1378176;670940;707236
09163;      Rosenheim, Stadt;unter 3 Jahre;1616;822;794
09163;      Rosenheim, Stadt;3 bis unter 6 Jahre;1578;779;799
09163;      Rosenheim, Stadt;6 bis unter 10 Jahre;2153;1122;1031
09163;      Rosenheim, Stadt;10 bis unter 15 Jahre;2793;1412;1381
09163;      Rosenheim, Stadt;15 bis unter 18 Jahre;1661;859;802
09163;      Rosenheim, Stadt;18 bis unter 20 Jahre;1261;664;597
09163;      Rosenheim, Stadt;20 bis unter 25 Jahre;3954;1986;1968
09163;      Rosenheim, Stadt;25 bis unter 30 Jahre;4222;2149;2073
09163;      Rosenheim, Stadt;30 bis unter 35 Jahre;4095;2024;2071
09163;      Rosenheim, Stadt;35 bis unter 40 Jahre;3916;1991;1925
09163;      Rosenheim, Stadt;40 bis unter 45 Jahre;4591;2392;2199
09163;      Rosenheim, Stadt;45 bis unter 50 Jahre;5489;2853;2636
09163;      Rosenheim, Stadt;50 bis unter 55 Jahre;4370;2262;2108
09163;      Rosenheim, Stadt;55 bis unter 60 Jahre;3658;1711;1947
09163;      Rosenheim, Stadt;60 bis unter 65 Jahre;3775;1784;1991
09163;      Rosenheim, Stadt;65 bis unter 75 Jahre;6840;3209;3631
09163;      Rosenheim, Stadt;75 Jahre und mehr;5540;2070;3470
09163;      Rosenheim, Stadt;Insgesamt;61512;30089;31423
09171;      Altötting, Landkreis;unter 3 Jahre;2628;1403;1225
09171;      Altötting, Landkreis;3 bis unter 6 Jahre;2759;1423;1336
09171;      Altötting, Landkreis;6 bis unter 10 Jahre;4077;2086;1991
09171;      Altötting, Landkreis;10 bis unter 15 Jahre;5524;2791;2733
09171;      Altötting, Landkreis;15 bis unter 18 Jahre;3559;1863;1696
09171;      Altötting, Landkreis;18 bis unter 20 Jahre;2568;1267;1301
09171;      Altötting, Landkreis;20 bis unter 25 Jahre;6124;3220;2904
09171;      Altötting, Landkreis;25 bis unter 30 Jahre;5933;3022;2911
09171;      Altötting, Landkreis;30 bis unter 35 Jahre;5919;2987;2932
09171;      Altötting, Landkreis;35 bis unter 40 Jahre;6267;3197;3070
09171;      Altötting, Landkreis;40 bis unter 45 Jahre;8317;4293;4024
09171;      Altötting, Landkreis;45 bis unter 50 Jahre;9300;4643;4657
09171;      Altötting, Landkreis;50 bis unter 55 Jahre;8789;4440;4349
09171;      Altötting, Landkreis;55 bis unter 60 Jahre;7308;3604;3704
09171;      Altötting, Landkreis;60 bis unter 65 Jahre;6616;3221;3395
09171;      Altötting, Landkreis;65 bis unter 75 Jahre;11767;5519;6248
09171;      Altötting, Landkreis;75 Jahre und mehr;10546;3990;6556
09171;      Altötting, Landkreis;Insgesamt;108001;52969;55032
09172;      Berchtesgadener Land, Landkreis;unter 3 Jahre;2313;1172;1141
09172;      Berchtesgadener Land, Landkreis;3 bis unter 6 Jahre;2450;1278;1172
09172;      Berchtesgadener Land, Landkreis;6 bis unter 10 Jahre;3378;1736;1642
09172;      Berchtesgadener Land, Landkreis;10 bis unter 15 Jahre;4881;2568;2313
09172;      Berchtesgadener Land, Landkreis;15 bis unter 18 Jahre;2993;1526;1467
09172;      Berchtesgadener Land, Landkreis;18 bis unter 20 Jahre;2267;1188;1079
09172;      Berchtesgadener Land, Landkreis;20 bis unter 25 Jahre;6129;3205;2924
09172;      Berchtesgadener Land, Landkreis;25 bis unter 30 Jahre;6285;3265;3020
09172;      Berchtesgadener Land, Landkreis;30 bis unter 35 Jahre;5873;2953;2920
09172;      Berchtesgadener Land, Landkreis;35 bis unter 40 Jahre;5793;2963;2830
09172;      Berchtesgadener Land, Landkreis;40 bis unter 45 Jahre;7934;4018;3916
09172;      Berchtesgadener Land, Landkreis;45 bis unter 50 Jahre;8651;4274;4377
09172;      Berchtesgadener Land, Landkreis;50 bis unter 55 Jahre;7476;3747;3729
09172;      Berchtesgadener Land, Landkreis;55 bis unter 60 Jahre;6303;3040;3263
09172;      Berchtesgadener Land, Landkreis;60 bis unter 65 Jahre;6343;3014;3329
09172;      Berchtesgadener Land, Landkreis;65 bis unter 75 Jahre;12607;5913;6694
09172;      Berchtesgadener Land, Landkreis;75 Jahre und mehr;11318;4270;7048
09172;      Berchtesgadener Land, Landkreis;Insgesamt;102994;50130;52864
09173;      Bad Tölz-Wolfratshausen, Landkreis;unter 3 Jahre;3058;1571;1487
09173;      Bad Tölz-Wolfratshausen, Landkreis;3 bis unter 6 Jahre;3294;1716;1578
09173;      Bad Tölz-Wolfratshausen, Landkreis;6 bis unter 10 Jahre;4677;2374;2303
09173;      Bad Tölz-Wolfratshausen, Landkreis;10 bis unter 15 Jahre;6454;3336;3118
09173;      Bad Tölz-Wolfratshausen, Landkreis;15 bis unter 18 Jahre;4085;2123;1962
09173;      Bad Tölz-Wolfratshausen, Landkreis;18 bis unter 20 Jahre;2707;1393;1314
09173;      Bad Tölz-Wolfratshausen, Landkreis;20 bis unter 25 Jahre;6679;3410;3269
09173;      Bad Tölz-Wolfratshausen, Landkreis;25 bis unter 30 Jahre;6416;3221;3195
09173;      Bad Tölz-Wolfratshausen, Landkreis;30 bis unter 35 Jahre;6762;3359;3403
09173;      Bad Tölz-Wolfratshausen, Landkreis;35 bis unter 40 Jahre;7133;3471;3662
09173;      Bad Tölz-Wolfratshausen, Landkreis;40 bis unter 45 Jahre;10066;4918;5148
09173;      Bad Tölz-Wolfratshausen, Landkreis;45 bis unter 50 Jahre;11265;5676;5589
09173;      Bad Tölz-Wolfratshausen, Landkreis;50 bis unter 55 Jahre;9529;4808;4721
09173;      Bad Tölz-Wolfratshausen, Landkreis;55 bis unter 60 Jahre;7733;3813;3920
09173;      Bad Tölz-Wolfratshausen, Landkreis;60 bis unter 65 Jahre;7045;3358;3687
09173;      Bad Tölz-Wolfratshausen, Landkreis;65 bis unter 75 Jahre;13938;6667;7271
09173;      Bad Tölz-Wolfratshausen, Landkreis;75 Jahre und mehr;11501;4548;6953
09173;      Bad Tölz-Wolfratshausen, Landkreis;Insgesamt;122342;59762;62580
09174;      Dachau, Landkreis;unter 3 Jahre;3843;1977;1866
09174;      Dachau, Landkreis;3 bis unter 6 Jahre;4099;2127;1972
09174;      Dachau, Landkreis;6 bis unter 10 Jahre;5450;2774;2676
09174;      Dachau, Landkreis;10 bis unter 15 Jahre;7489;3951;3538
09174;      Dachau, Landkreis;15 bis unter 18 Jahre;4694;2366;2328
09174;      Dachau, Landkreis;18 bis unter 20 Jahre;3220;1592;1628
09174;      Dachau, Landkreis;20 bis unter 25 Jahre;8134;4285;3849
09174;      Dachau, Landkreis;25 bis unter 30 Jahre;7969;3995;3974
09174;      Dachau, Landkreis;30 bis unter 35 Jahre;8798;4400;4398
09174;      Dachau, Landkreis;35 bis unter 40 Jahre;8985;4470;4515
09174;      Dachau, Landkreis;40 bis unter 45 Jahre;12152;6071;6081
09174;      Dachau, Landkreis;45 bis unter 50 Jahre;12956;6615;6341
09174;      Dachau, Landkreis;50 bis unter 55 Jahre;11070;5627;5443
09174;      Dachau, Landkreis;55 bis unter 60 Jahre;8753;4412;4341
09174;      Dachau, Landkreis;60 bis unter 65 Jahre;7895;3882;4013
09174;      Dachau, Landkreis;65 bis unter 75 Jahre;14022;6827;7195
09174;      Dachau, Landkreis;75 Jahre und mehr;10690;4202;6488
09174;      Dachau, Landkreis;Insgesamt;140219;69573;70646
09175;      Ebersberg, Landkreis;unter 3 Jahre;3693;1917;1776
09175;      Ebersberg, Landkreis;3 bis unter 6 Jahre;4010;2091;1919
09175;      Ebersberg, Landkreis;6 bis unter 10 Jahre;5422;2813;2609
09175;      Ebersberg, Landkreis;10 bis unter 15 Jahre;7533;3892;3641
09175;      Ebersberg, Landkreis;15 bis unter 18 Jahre;4404;2244;2160
09175;      Ebersberg, Landkreis;18 bis unter 20 Jahre;2947;1521;1426
09175;      Ebersberg, Landkreis;20 bis unter 25 Jahre;6894;3490;3404
09175;      Ebersberg, Landkreis;25 bis unter 30 Jahre;6567;3287;3280
09175;      Ebersberg, Landkreis;30 bis unter 35 Jahre;7593;3710;3883
09175;      Ebersberg, Landkreis;35 bis unter 40 Jahre;8382;4080;4302
09175;      Ebersberg, Landkreis;40 bis unter 45 Jahre;11742;5928;5814
09175;      Ebersberg, Landkreis;45 bis unter 50 Jahre;12230;6195;6035
09175;      Ebersberg, Landkreis;50 bis unter 55 Jahre;10161;5214;4947
09175;      Ebersberg, Landkreis;55 bis unter 60 Jahre;7623;3786;3837
09175;      Ebersberg, Landkreis;60 bis unter 65 Jahre;7148;3497;3651
09175;      Ebersberg, Landkreis;65 bis unter 75 Jahre;14083;6798;7285
09175;      Ebersberg, Landkreis;75 Jahre und mehr;10386;4302;6084
09175;      Ebersberg, Landkreis;Insgesamt;130818;64765;66053
09176;      Eichstätt, Landkreis;unter 3 Jahre;3422;1782;1640
09176;      Eichstätt, Landkreis;3 bis unter 6 Jahre;3591;1858;1733
09176;      Eichstätt, Landkreis;6 bis unter 10 Jahre;5162;2651;2511
09176;      Eichstätt, Landkreis;10 bis unter 15 Jahre;7331;3734;3597
09176;      Eichstätt, Landkreis;15 bis unter 18 Jahre;4528;2337;2191
09176;      Eichstätt, Landkreis;18 bis unter 20 Jahre;3079;1559;1520
09176;      Eichstätt, Landkreis;20 bis unter 25 Jahre;8221;4142;4079
09176;      Eichstätt, Landkreis;25 bis unter 30 Jahre;7560;3877;3683
09176;      Eichstätt, Landkreis;30 bis unter 35 Jahre;7851;4043;3808
09176;      Eichstätt, Landkreis;35 bis unter 40 Jahre;7691;4029;3662
09176;      Eichstätt, Landkreis;40 bis unter 45 Jahre;10044;5051;4993
09176;      Eichstätt, Landkreis;45 bis unter 50 Jahre;11066;5713;5353
09176;      Eichstätt, Landkreis;50 bis unter 55 Jahre;10137;5264;4873
09176;      Eichstätt, Landkreis;55 bis unter 60 Jahre;7878;4066;3812
09176;      Eichstätt, Landkreis;60 bis unter 65 Jahre;6631;3411;3220
09176;      Eichstätt, Landkreis;65 bis unter 75 Jahre;11220;5514;5706
09176;      Eichstätt, Landkreis;75 Jahre und mehr;10115;4090;6025
09176;      Eichstätt, Landkreis;Insgesamt;125527;63121;62406
09177;      Erding, Landkreis;unter 3 Jahre;3609;1874;1735
09177;      Erding, Landkreis;3 bis unter 6 Jahre;3822;1934;1888
09177;      Erding, Landkreis;6 bis unter 10 Jahre;5523;2858;2665
09177;      Erding, Landkreis;10 bis unter 15 Jahre;7363;3723;3640
09177;      Erding, Landkreis;15 bis unter 18 Jahre;4562;2356;2206
09177;      Erding, Landkreis;18 bis unter 20 Jahre;3098;1594;1504
09177;      Erding, Landkreis;20 bis unter 25 Jahre;7393;3877;3516
09177;      Erding, Landkreis;25 bis unter 30 Jahre;7375;3657;3718
09177;      Erding, Landkreis;30 bis unter 35 Jahre;7933;3905;4028
09177;      Erding, Landkreis;35 bis unter 40 Jahre;8475;4263;4212
09177;      Erding, Landkreis;40 bis unter 45 Jahre;11616;5937;5679
09177;      Erding, Landkreis;45 bis unter 50 Jahre;12424;6321;6103
09177;      Erding, Landkreis;50 bis unter 55 Jahre;10119;5277;4842
09177;      Erding, Landkreis;55 bis unter 60 Jahre;7881;4062;3819
09177;      Erding, Landkreis;60 bis unter 65 Jahre;6863;3424;3439
09177;      Erding, Landkreis;65 bis unter 75 Jahre;11102;5500;5602
09177;      Erding, Landkreis;75 Jahre und mehr;9054;3656;5398
09177;      Erding, Landkreis;Insgesamt;128212;64218;63994
09178;      Freising, Landkreis;unter 3 Jahre;4838;2500;2338
09178;      Freising, Landkreis;3 bis unter 6 Jahre;4898;2501;2397
09178;      Freising, Landkreis;6 bis unter 10 Jahre;6567;3397;3170
09178;      Freising, Landkreis;10 bis unter 15 Jahre;8981;4664;4317
09178;      Freising, Landkreis;15 bis unter 18 Jahre;5507;2875;2632
09178;      Freising, Landkreis;18 bis unter 20 Jahre;3836;2005;1831
09178;      Freising, Landkreis;20 bis unter 25 Jahre;11551;5882;5669
09178;      Freising, Landkreis;25 bis unter 30 Jahre;11409;5828;5581
09178;      Freising, Landkreis;30 bis unter 35 Jahre;11699;5875;5824
09178;      Freising, Landkreis;35 bis unter 40 Jahre;11275;5792;5483
09178;      Freising, Landkreis;40 bis unter 45 Jahre;14814;7590;7224
09178;      Freising, Landkreis;45 bis unter 50 Jahre;16048;8428;7620
09178;      Freising, Landkreis;50 bis unter 55 Jahre;12865;6784;6081
09178;      Freising, Landkreis;55 bis unter 60 Jahre;9666;5041;4625
09178;      Freising, Landkreis;60 bis unter 65 Jahre;8324;4082;4242
09178;      Freising, Landkreis;65 bis unter 75 Jahre;14617;7333;7284
09178;      Freising, Landkreis;75 Jahre und mehr;11285;4499;6786
09178;      Freising, Landkreis;Insgesamt;168180;85076;83104
09179;      Fürstenfeldbruck, Landkreis;unter 3 Jahre;5686;2916;2770
09179;      Fürstenfeldbruck, Landkreis;3 bis unter 6 Jahre;5774;2956;2818
09179;      Fürstenfeldbruck, Landkreis;6 bis unter 10 Jahre;7962;4034;3928
09179;      Fürstenfeldbruck, Landkreis;10 bis unter 15 Jahre;10368;5406;4962
09179;      Fürstenfeldbruck, Landkreis;15 bis unter 18 Jahre;6445;3344;3101
09179;      Fürstenfeldbruck, Landkreis;18 bis unter 20 Jahre;4383;2238;2145
09179;      Fürstenfeldbruck, Landkreis;20 bis unter 25 Jahre;10769;5484;5285
09179;      Fürstenfeldbruck, Landkreis;25 bis unter 30 Jahre;10821;5363;5458
09179;      Fürstenfeldbruck, Landkreis;30 bis unter 35 Jahre;12079;5838;6241
09179;      Fürstenfeldbruck, Landkreis;35 bis unter 40 Jahre;12738;6189;6549
09179;      Fürstenfeldbruck, Landkreis;40 bis unter 45 Jahre;17248;8799;8449
09179;      Fürstenfeldbruck, Landkreis;45 bis unter 50 Jahre;18729;9553;9176
09179;      Fürstenfeldbruck, Landkreis;50 bis unter 55 Jahre;15418;7695;7723
09179;      Fürstenfeldbruck, Landkreis;55 bis unter 60 Jahre;12586;6061;6525
09179;      Fürstenfeldbruck, Landkreis;60 bis unter 65 Jahre;12506;5887;6619
09179;      Fürstenfeldbruck, Landkreis;65 bis unter 75 Jahre;25649;12108;13541
09179;      Fürstenfeldbruck, Landkreis;75 Jahre und mehr;17572;7186;10386
09179;      Fürstenfeldbruck, Landkreis;Insgesamt;206733;101057;105676
09180;      Garmisch-Partenkirchen, Landkreis;unter 3 Jahre;1961;1037;924
09180;      Garmisch-Partenkirchen, Landkreis;3 bis unter 6 Jahre;2009;1023;986
09180;      Garmisch-Partenkirchen, Landkreis;6 bis unter 10 Jahre;2762;1389;1373
09180;      Garmisch-Partenkirchen, Landkreis;10 bis unter 15 Jahre;4137;2128;2009
09180;      Garmisch-Partenkirchen, Landkreis;15 bis unter 18 Jahre;2736;1424;1312
09180;      Garmisch-Partenkirchen, Landkreis;18 bis unter 20 Jahre;1840;971;869
09180;      Garmisch-Partenkirchen, Landkreis;20 bis unter 25 Jahre;4583;2384;2199
09180;      Garmisch-Partenkirchen, Landkreis;25 bis unter 30 Jahre;4465;2208;2257
09180;      Garmisch-Partenkirchen, Landkreis;30 bis unter 35 Jahre;4649;2258;2391
09180;      Garmisch-Partenkirchen, Landkreis;35 bis unter 40 Jahre;4706;2285;2421
09180;      Garmisch-Partenkirchen, Landkreis;40 bis unter 45 Jahre;7165;3566;3599
09180;      Garmisch-Partenkirchen, Landkreis;45 bis unter 50 Jahre;7742;3909;3833
09180;      Garmisch-Partenkirchen, Landkreis;50 bis unter 55 Jahre;6299;3143;3156
09180;      Garmisch-Partenkirchen, Landkreis;55 bis unter 60 Jahre;5265;2588;2677
09180;      Garmisch-Partenkirchen, Landkreis;60 bis unter 65 Jahre;5356;2479;2877
09180;      Garmisch-Partenkirchen, Landkreis;65 bis unter 75 Jahre;11314;5262;6052
09180;      Garmisch-Partenkirchen, Landkreis;75 Jahre und mehr;9599;3815;5784
09180;      Garmisch-Partenkirchen, Landkreis;Insgesamt;86588;41869;44719
09181;      Landsberg am Lech, Landkreis;unter 3 Jahre;2893;1509;1384
09181;      Landsberg am Lech, Landkreis;3 bis unter 6 Jahre;3272;1667;1605
09181;      Landsberg am Lech, Landkreis;6 bis unter 10 Jahre;4719;2407;2312
09181;      Landsberg am Lech, Landkreis;10 bis unter 15 Jahre;6946;3586;3360
09181;      Landsberg am Lech, Landkreis;15 bis unter 18 Jahre;4191;2157;2034
09181;      Landsberg am Lech, Landkreis;18 bis unter 20 Jahre;2819;1465;1354
09181;      Landsberg am Lech, Landkreis;20 bis unter 25 Jahre;6072;3165;2907
09181;      Landsberg am Lech, Landkreis;25 bis unter 30 Jahre;5697;2983;2714
09181;      Landsberg am Lech, Landkreis;30 bis unter 35 Jahre;6277;3168;3109
09181;      Landsberg am Lech, Landkreis;35 bis unter 40 Jahre;6866;3325;3541
09181;      Landsberg am Lech, Landkreis;40 bis unter 45 Jahre;9851;4976;4875
09181;      Landsberg am Lech, Landkreis;45 bis unter 50 Jahre;11470;6014;5456
09181;      Landsberg am Lech, Landkreis;50 bis unter 55 Jahre;9240;4720;4520
09181;      Landsberg am Lech, Landkreis;55 bis unter 60 Jahre;7184;3554;3630
09181;      Landsberg am Lech, Landkreis;60 bis unter 65 Jahre;6660;3351;3309
09181;      Landsberg am Lech, Landkreis;65 bis unter 75 Jahre;11819;5896;5923
09181;      Landsberg am Lech, Landkreis;75 Jahre und mehr;9239;3694;5545
09181;      Landsberg am Lech, Landkreis;Insgesamt;115215;57637;57578
09182;      Miesbach, Landkreis;unter 3 Jahre;2395;1215;1180
09182;      Miesbach, Landkreis;3 bis unter 6 Jahre;2525;1337;1188
09182;      Miesbach, Landkreis;6 bis unter 10 Jahre;3463;1738;1725
09182;      Miesbach, Landkreis;10 bis unter 15 Jahre;4722;2498;2224
09182;      Miesbach, Landkreis;15 bis unter 18 Jahre;2969;1559;1410
09182;      Miesbach, Landkreis;18 bis unter 20 Jahre;2123;1083;1040
09182;      Miesbach, Landkreis;20 bis unter 25 Jahre;5134;2599;2535
09182;      Miesbach, Landkreis;25 bis unter 30 Jahre;4858;2507;2351
09182;      Miesbach, Landkreis;30 bis unter 35 Jahre;5108;2440;2668
09182;      Miesbach, Landkreis;35 bis unter 40 Jahre;5554;2662;2892
09182;      Miesbach, Landkreis;40 bis unter 45 Jahre;8099;3932;4167
09182;      Miesbach, Landkreis;45 bis unter 50 Jahre;8726;4191;4535
09182;      Miesbach, Landkreis;50 bis unter 55 Jahre;7417;3690;3727
09182;      Miesbach, Landkreis;55 bis unter 60 Jahre;5748;2803;2945
09182;      Miesbach, Landkreis;60 bis unter 65 Jahre;5784;2688;3096
09182;      Miesbach, Landkreis;65 bis unter 75 Jahre;11902;5524;6378
09182;      Miesbach, Landkreis;75 Jahre und mehr;9444;3735;5709
09182;      Miesbach, Landkreis;Insgesamt;95971;46201;49770
09183;      Mühldorf a.Inn, Landkreis;unter 3 Jahre;2805;1464;1341
09183;      Mühldorf a.Inn, Landkreis;3 bis unter 6 Jahre;2886;1499;1387
09183;      Mühldorf a.Inn, Landkreis;6 bis unter 10 Jahre;4119;2110;2009
09183;      Mühldorf a.Inn, Landkreis;10 bis unter 15 Jahre;5963;2988;2975
09183;      Mühldorf a.Inn, Landkreis;15 bis unter 18 Jahre;3849;1984;1865
09183;      Mühldorf a.Inn, Landkreis;18 bis unter 20 Jahre;2655;1374;1281
09183;      Mühldorf a.Inn, Landkreis;20 bis unter 25 Jahre;6489;3397;3092
09183;      Mühldorf a.Inn, Landkreis;25 bis unter 30 Jahre;5934;3069;2865
09183;      Mühldorf a.Inn, Landkreis;30 bis unter 35 Jahre;6301;3238;3063
09183;      Mühldorf a.Inn, Landkreis;35 bis unter 40 Jahre;6596;3370;3226
09183;      Mühldorf a.Inn, Landkreis;40 bis unter 45 Jahre;8867;4637;4230
09183;      Mühldorf a.Inn, Landkreis;45 bis unter 50 Jahre;9753;5057;4696
09183;      Mühldorf a.Inn, Landkreis;50 bis unter 55 Jahre;8933;4592;4341
09183;      Mühldorf a.Inn, Landkreis;55 bis unter 60 Jahre;7298;3774;3524
09183;      Mühldorf a.Inn, Landkreis;60 bis unter 65 Jahre;6516;3170;3346
09183;      Mühldorf a.Inn, Landkreis;65 bis unter 75 Jahre;11584;5628;5956
09183;      Mühldorf a.Inn, Landkreis;75 Jahre und mehr;10132;3911;6221
09183;      Mühldorf a.Inn, Landkreis;Insgesamt;110680;55262;55418
09184;      München, Landkreis;unter 3 Jahre;9380;4864;4516
09184;      München, Landkreis;3 bis unter 6 Jahre;10206;5214;4992
09184;      München, Landkreis;6 bis unter 10 Jahre;13491;6975;6516
09184;      München, Landkreis;10 bis unter 15 Jahre;16472;8435;8037
09184;      München, Landkreis;15 bis unter 18 Jahre;9370;4917;4453
09184;      München, Landkreis;18 bis unter 20 Jahre;6240;3202;3038
09184;      München, Landkreis;20 bis unter 25 Jahre;17829;9633;8196
09184;      München, Landkreis;25 bis unter 30 Jahre;17668;8948;8720
09184;      München, Landkreis;30 bis unter 35 Jahre;20132;9810;10322
09184;      München, Landkreis;35 bis unter 40 Jahre;21304;10456;10848
09184;      München, Landkreis;40 bis unter 45 Jahre;28861;14455;14406
09184;      München, Landkreis;45 bis unter 50 Jahre;29210;15004;14206
09184;      München, Landkreis;50 bis unter 55 Jahre;23514;11859;11655
09184;      München, Landkreis;55 bis unter 60 Jahre;18991;9393;9598
09184;      München, Landkreis;60 bis unter 65 Jahre;18410;8662;9748
09184;      München, Landkreis;65 bis unter 75 Jahre;39168;18542;20626
09184;      München, Landkreis;75 Jahre und mehr;27716;11600;16116
09184;      München, Landkreis;Insgesamt;327962;161969;165993
09185;      Neuburg-Schrobenhausen, Landkreis;unter 3 Jahre;2413;1256;1157
09185;      Neuburg-Schrobenhausen, Landkreis;3 bis unter 6 Jahre;2528;1248;1280
09185;      Neuburg-Schrobenhausen, Landkreis;6 bis unter 10 Jahre;3547;1819;1728
09185;      Neuburg-Schrobenhausen, Landkreis;10 bis unter 15 Jahre;5212;2635;2577
09185;      Neuburg-Schrobenhausen, Landkreis;15 bis unter 18 Jahre;3256;1653;1603
09185;      Neuburg-Schrobenhausen, Landkreis;18 bis unter 20 Jahre;2279;1147;1132
09185;      Neuburg-Schrobenhausen, Landkreis;20 bis unter 25 Jahre;5452;2941;2511
09185;      Neuburg-Schrobenhausen, Landkreis;25 bis unter 30 Jahre;5363;2770;2593
09185;      Neuburg-Schrobenhausen, Landkreis;30 bis unter 35 Jahre;5713;2930;2783
09185;      Neuburg-Schrobenhausen, Landkreis;35 bis unter 40 Jahre;5720;2975;2745
09185;      Neuburg-Schrobenhausen, Landkreis;40 bis unter 45 Jahre;7242;3781;3461
09185;      Neuburg-Schrobenhausen, Landkreis;45 bis unter 50 Jahre;7987;4091;3896
09185;      Neuburg-Schrobenhausen, Landkreis;50 bis unter 55 Jahre;7507;3820;3687
09185;      Neuburg-Schrobenhausen, Landkreis;55 bis unter 60 Jahre;5935;2995;2940
09185;      Neuburg-Schrobenhausen, Landkreis;60 bis unter 65 Jahre;5186;2635;2551
09185;      Neuburg-Schrobenhausen, Landkreis;65 bis unter 75 Jahre;8967;4371;4596
09185;      Neuburg-Schrobenhausen, Landkreis;75 Jahre und mehr;7591;2801;4790
09185;      Neuburg-Schrobenhausen, Landkreis;Insgesamt;91898;45868;46030
09186;      Pfaffenhofen a.d.Ilm, Landkreis;unter 3 Jahre;3106;1607;1499
09186;      Pfaffenhofen a.d.Ilm, Landkreis;3 bis unter 6 Jahre;3221;1663;1558
09186;      Pfaffenhofen a.d.Ilm, Landkreis;6 bis unter 10 Jahre;4566;2303;2263
09186;      Pfaffenhofen a.d.Ilm, Landkreis;10 bis unter 15 Jahre;6549;3370;3179
09186;      Pfaffenhofen a.d.Ilm, Landkreis;15 bis unter 18 Jahre;4106;2091;2015
09186;      Pfaffenhofen a.d.Ilm, Landkreis;18 bis unter 20 Jahre;2821;1460;1361
09186;      Pfaffenhofen a.d.Ilm, Landkreis;20 bis unter 25 Jahre;6848;3688;3160
09186;      Pfaffenhofen a.d.Ilm, Landkreis;25 bis unter 30 Jahre;6978;3570;3408
09186;      Pfaffenhofen a.d.Ilm, Landkreis;30 bis unter 35 Jahre;7232;3677;3555
09186;      Pfaffenhofen a.d.Ilm, Landkreis;35 bis unter 40 Jahre;7384;3739;3645
09186;      Pfaffenhofen a.d.Ilm, Landkreis;40 bis unter 45 Jahre;9826;5062;4764
09186;      Pfaffenhofen a.d.Ilm, Landkreis;45 bis unter 50 Jahre;11028;5657;5371
09186;      Pfaffenhofen a.d.Ilm, Landkreis;50 bis unter 55 Jahre;9805;5064;4741
09186;      Pfaffenhofen a.d.Ilm, Landkreis;55 bis unter 60 Jahre;7868;4001;3867
09186;      Pfaffenhofen a.d.Ilm, Landkreis;60 bis unter 65 Jahre;6434;3238;3196
09186;      Pfaffenhofen a.d.Ilm, Landkreis;65 bis unter 75 Jahre;11320;5567;5753
09186;      Pfaffenhofen a.d.Ilm, Landkreis;75 Jahre und mehr;9063;3607;5456
09186;      Pfaffenhofen a.d.Ilm, Landkreis;Insgesamt;118155;59364;58791
09187;      Rosenheim, Landkreis;unter 3 Jahre;6394;3247;3147
09187;      Rosenheim, Landkreis;3 bis unter 6 Jahre;6584;3430;3154
09187;      Rosenheim, Landkreis;6 bis unter 10 Jahre;9726;4973;4753
09187;      Rosenheim, Landkreis;10 bis unter 15 Jahre;13639;7022;6617
09187;      Rosenheim, Landkreis;15 bis unter 18 Jahre;8617;4566;4051
09187;      Rosenheim, Landkreis;18 bis unter 20 Jahre;6118;3084;3034
09187;      Rosenheim, Landkreis;20 bis unter 25 Jahre;14228;7529;6699
09187;      Rosenheim, Landkreis;25 bis unter 30 Jahre;13122;6721;6401
09187;      Rosenheim, Landkreis;30 bis unter 35 Jahre;13469;6679;6790
09187;      Rosenheim, Landkreis;35 bis unter 40 Jahre;14736;7228;7508
09187;      Rosenheim, Landkreis;40 bis unter 45 Jahre;20876;10491;10385
09187;      Rosenheim, Landkreis;45 bis unter 50 Jahre;22784;11421;11363
09187;      Rosenheim, Landkreis;50 bis unter 55 Jahre;19809;10061;9748
09187;      Rosenheim, Landkreis;55 bis unter 60 Jahre;15961;7898;8063
09187;      Rosenheim, Landkreis;60 bis unter 65 Jahre;15240;7501;7739
09187;      Rosenheim, Landkreis;65 bis unter 75 Jahre;27810;13460;14350
09187;      Rosenheim, Landkreis;75 Jahre und mehr;21992;8678;13314
09187;      Rosenheim, Landkreis;Insgesamt;251105;123989;127116
09188;      Starnberg, Landkreis;unter 3 Jahre;3326;1653;1673
09188;      Starnberg, Landkreis;3 bis unter 6 Jahre;3714;1944;1770
09188;      Starnberg, Landkreis;6 bis unter 10 Jahre;5374;2766;2608
09188;      Starnberg, Landkreis;10 bis unter 15 Jahre;7066;3714;3352
09188;      Starnberg, Landkreis;15 bis unter 18 Jahre;4127;2099;2028
09188;      Starnberg, Landkreis;18 bis unter 20 Jahre;2677;1370;1307
09188;      Starnberg, Landkreis;20 bis unter 25 Jahre;6184;3127;3057
09188;      Starnberg, Landkreis;25 bis unter 30 Jahre;5831;2964;2867
09188;      Starnberg, Landkreis;30 bis unter 35 Jahre;6696;3163;3533
09188;      Starnberg, Landkreis;35 bis unter 40 Jahre;7569;3501;4068
09188;      Starnberg, Landkreis;40 bis unter 45 Jahre;11067;5353;5714
09188;      Starnberg, Landkreis;45 bis unter 50 Jahre;12367;6036;6331
09188;      Starnberg, Landkreis;50 bis unter 55 Jahre;9933;4761;5172
09188;      Starnberg, Landkreis;55 bis unter 60 Jahre;8014;3816;4198
09188;      Starnberg, Landkreis;60 bis unter 65 Jahre;7998;3696;4302
09188;      Starnberg, Landkreis;65 bis unter 75 Jahre;16900;7985;8915
09188;      Starnberg, Landkreis;75 Jahre und mehr;12748;5196;7552
09188;      Starnberg, Landkreis;Insgesamt;131591;63144;68447
09189;      Traunstein, Landkreis;unter 3 Jahre;4034;2075;1959
09189;      Traunstein, Landkreis;3 bis unter 6 Jahre;4364;2151;2213
09189;      Traunstein, Landkreis;6 bis unter 10 Jahre;6128;3135;2993
09189;      Traunstein, Landkreis;10 bis unter 15 Jahre;8774;4475;4299
09189;      Traunstein, Landkreis;15 bis unter 18 Jahre;5700;2894;2806
09189;      Traunstein, Landkreis;18 bis unter 20 Jahre;4027;2086;1941
09189;      Traunstein, Landkreis;20 bis unter 25 Jahre;9539;5022;4517
09189;      Traunstein, Landkreis;25 bis unter 30 Jahre;8938;4605;4333
09189;      Traunstein, Landkreis;30 bis unter 35 Jahre;9035;4495;4540
09189;      Traunstein, Landkreis;35 bis unter 40 Jahre;9799;4881;4918
09189;      Traunstein, Landkreis;40 bis unter 45 Jahre;13335;6755;6580
09189;      Traunstein, Landkreis;45 bis unter 50 Jahre;14702;7340;7362
09189;      Traunstein, Landkreis;50 bis unter 55 Jahre;13541;6786;6755
09189;      Traunstein, Landkreis;55 bis unter 60 Jahre;10982;5367;5615
09189;      Traunstein, Landkreis;60 bis unter 65 Jahre;10717;5119;5598
09189;      Traunstein, Landkreis;65 bis unter 75 Jahre;20008;9512;10496
09189;      Traunstein, Landkreis;75 Jahre und mehr;17231;6693;10538
09189;      Traunstein, Landkreis;Insgesamt;170854;83391;87463
09190;      Weilheim-Schongau, Landkreis;unter 3 Jahre;3388;1729;1659
09190;      Weilheim-Schongau, Landkreis;3 bis unter 6 Jahre;3613;1868;1745
09190;      Weilheim-Schongau, Landkreis;6 bis unter 10 Jahre;5006;2547;2459
09190;      Weilheim-Schongau, Landkreis;10 bis unter 15 Jahre;7214;3734;3480
09190;      Weilheim-Schongau, Landkreis;15 bis unter 18 Jahre;4708;2455;2253
09190;      Weilheim-Schongau, Landkreis;18 bis unter 20 Jahre;3278;1682;1596
09190;      Weilheim-Schongau, Landkreis;20 bis unter 25 Jahre;7352;3811;3541
09190;      Weilheim-Schongau, Landkreis;25 bis unter 30 Jahre;6833;3498;3335
09190;      Weilheim-Schongau, Landkreis;30 bis unter 35 Jahre;6972;3522;3450
09190;      Weilheim-Schongau, Landkreis;35 bis unter 40 Jahre;7325;3648;3677
09190;      Weilheim-Schongau, Landkreis;40 bis unter 45 Jahre;10467;5068;5399
09190;      Weilheim-Schongau, Landkreis;45 bis unter 50 Jahre;11820;5984;5836
09190;      Weilheim-Schongau, Landkreis;50 bis unter 55 Jahre;10247;5226;5021
09190;      Weilheim-Schongau, Landkreis;55 bis unter 60 Jahre;8635;4324;4311
09190;      Weilheim-Schongau, Landkreis;60 bis unter 65 Jahre;7690;3848;3842
09190;      Weilheim-Schongau, Landkreis;65 bis unter 75 Jahre;14732;7260;7472
09190;      Weilheim-Schongau, Landkreis;75 Jahre und mehr;11961;4733;7228
09190;      Weilheim-Schongau, Landkreis;Insgesamt;131241;64937;66304
092;    Niederbayern, Regierungsbezirk;unter 3 Jahre;28444;14630;13814
092;    Niederbayern, Regierungsbezirk;3 bis unter 6 Jahre;29923;15420;14503
092;    Niederbayern, Regierungsbezirk;6 bis unter 10 Jahre;43269;22225;21044
092;    Niederbayern, Regierungsbezirk;10 bis unter 15 Jahre;62037;31884;30153
092;    Niederbayern, Regierungsbezirk;15 bis unter 18 Jahre;39374;20233;19141
092;    Niederbayern, Regierungsbezirk;18 bis unter 20 Jahre;27988;14353;13635
092;    Niederbayern, Regierungsbezirk;20 bis unter 25 Jahre;72883;38291;34592
092;    Niederbayern, Regierungsbezirk;25 bis unter 30 Jahre;68154;35200;32954
092;    Niederbayern, Regierungsbezirk;30 bis unter 35 Jahre;68064;34683;33381
092;    Niederbayern, Regierungsbezirk;35 bis unter 40 Jahre;71755;36626;35129
092;    Niederbayern, Regierungsbezirk;40 bis unter 45 Jahre;95495;48819;46676
092;    Niederbayern, Regierungsbezirk;45 bis unter 50 Jahre;104048;53094;50954
092;    Niederbayern, Regierungsbezirk;50 bis unter 55 Jahre;98054;49627;48427
092;    Niederbayern, Regierungsbezirk;55 bis unter 60 Jahre;81488;40880;40608
092;    Niederbayern, Regierungsbezirk;60 bis unter 65 Jahre;71866;36060;35806
092;    Niederbayern, Regierungsbezirk;65 bis unter 75 Jahre;120654;57860;62794
092;    Niederbayern, Regierungsbezirk;75 Jahre und mehr;109047;41152;67895
092;    Niederbayern, Regierungsbezirk;Insgesamt;1192543;591037;601506
09261;      Landshut, Stadt;unter 3 Jahre;1810;926;884
09261;      Landshut, Stadt;3 bis unter 6 Jahre;1659;875;784
09261;      Landshut, Stadt;6 bis unter 10 Jahre;2097;1047;1050
09261;      Landshut, Stadt;10 bis unter 15 Jahre;2549;1344;1205
09261;      Landshut, Stadt;15 bis unter 18 Jahre;1673;836;837
09261;      Landshut, Stadt;18 bis unter 20 Jahre;1285;603;682
09261;      Landshut, Stadt;20 bis unter 25 Jahre;4135;2135;2000
09261;      Landshut, Stadt;25 bis unter 30 Jahre;4197;2078;2119
09261;      Landshut, Stadt;30 bis unter 35 Jahre;4192;2102;2090
09261;      Landshut, Stadt;35 bis unter 40 Jahre;4106;2044;2062
09261;      Landshut, Stadt;40 bis unter 45 Jahre;5041;2550;2491
09261;      Landshut, Stadt;45 bis unter 50 Jahre;5094;2569;2525
09261;      Landshut, Stadt;50 bis unter 55 Jahre;4578;2219;2359
09261;      Landshut, Stadt;55 bis unter 60 Jahre;4177;1988;2189
09261;      Landshut, Stadt;60 bis unter 65 Jahre;3803;1778;2025
09261;      Landshut, Stadt;65 bis unter 75 Jahre;7137;3262;3875
09261;      Landshut, Stadt;75 Jahre und mehr;6725;2414;4311
09261;      Landshut, Stadt;Insgesamt;64258;30770;33488
09262;      Passau, Stadt;unter 3 Jahre;972;508;464
09262;      Passau, Stadt;3 bis unter 6 Jahre;1003;509;494
09262;      Passau, Stadt;6 bis unter 10 Jahre;1437;708;729
09262;      Passau, Stadt;10 bis unter 15 Jahre;1904;971;933
09262;      Passau, Stadt;15 bis unter 18 Jahre;1166;597;569
09262;      Passau, Stadt;18 bis unter 20 Jahre;995;488;507
09262;      Passau, Stadt;20 bis unter 25 Jahre;4373;1890;2483
09262;      Passau, Stadt;25 bis unter 30 Jahre;3750;1905;1845
09262;      Passau, Stadt;30 bis unter 35 Jahre;3019;1516;1503
09262;      Passau, Stadt;35 bis unter 40 Jahre;2708;1431;1277
09262;      Passau, Stadt;40 bis unter 45 Jahre;3675;1863;1812
09262;      Passau, Stadt;45 bis unter 50 Jahre;4312;2151;2161
09262;      Passau, Stadt;50 bis unter 55 Jahre;3835;1887;1948
09262;      Passau, Stadt;55 bis unter 60 Jahre;3286;1547;1739
09262;      Passau, Stadt;60 bis unter 65 Jahre;3076;1481;1595
09262;      Passau, Stadt;65 bis unter 75 Jahre;5706;2596;3110
09262;      Passau, Stadt;75 Jahre und mehr;5331;1927;3404
09262;      Passau, Stadt;Insgesamt;50548;23975;26573
09263;      Straubing;unter 3 Jahre;1022;546;476
09263;      Straubing;3 bis unter 6 Jahre;1066;552;514
09263;      Straubing;6 bis unter 10 Jahre;1333;697;636
09263;      Straubing;10 bis unter 15 Jahre;1754;888;866
09263;      Straubing;15 bis unter 18 Jahre;1227;611;616
09263;      Straubing;18 bis unter 20 Jahre;960;495;465
09263;      Straubing;20 bis unter 25 Jahre;2710;1404;1306
09263;      Straubing;25 bis unter 30 Jahre;2915;1498;1417
09263;      Straubing;30 bis unter 35 Jahre;2831;1567;1264
09263;      Straubing;35 bis unter 40 Jahre;2635;1483;1152
09263;      Straubing;40 bis unter 45 Jahre;3497;1889;1608
09263;      Straubing;45 bis unter 50 Jahre;3599;1903;1696
09263;      Straubing;50 bis unter 55 Jahre;3716;1916;1800
09263;      Straubing;55 bis unter 60 Jahre;3003;1436;1567
09263;      Straubing;60 bis unter 65 Jahre;2932;1467;1465
09263;      Straubing;65 bis unter 75 Jahre;4995;2295;2700
09263;      Straubing;75 Jahre und mehr;4529;1623;2906
09263;      Straubing;Insgesamt;44724;22270;22454
09271;      Deggendorf, Landkreis;unter 3 Jahre;2735;1417;1318
09271;      Deggendorf, Landkreis;3 bis unter 6 Jahre;2844;1437;1407
09271;      Deggendorf, Landkreis;6 bis unter 10 Jahre;4313;2211;2102
09271;      Deggendorf, Landkreis;10 bis unter 15 Jahre;6018;3080;2938
09271;      Deggendorf, Landkreis;15 bis unter 18 Jahre;3813;1975;1838
09271;      Deggendorf, Landkreis;18 bis unter 20 Jahre;2744;1379;1365
09271;      Deggendorf, Landkreis;20 bis unter 25 Jahre;7265;3797;3468
09271;      Deggendorf, Landkreis;25 bis unter 30 Jahre;6822;3587;3235
09271;      Deggendorf, Landkreis;30 bis unter 35 Jahre;6796;3431;3365
09271;      Deggendorf, Landkreis;35 bis unter 40 Jahre;7099;3642;3457
09271;      Deggendorf, Landkreis;40 bis unter 45 Jahre;9351;4645;4706
09271;      Deggendorf, Landkreis;45 bis unter 50 Jahre;10372;5208;5164
09271;      Deggendorf, Landkreis;50 bis unter 55 Jahre;9819;4869;4950
09271;      Deggendorf, Landkreis;55 bis unter 60 Jahre;8169;4125;4044
09271;      Deggendorf, Landkreis;60 bis unter 65 Jahre;7076;3563;3513
09271;      Deggendorf, Landkreis;65 bis unter 75 Jahre;11663;5590;6073
09271;      Deggendorf, Landkreis;75 Jahre und mehr;10382;3912;6470
09271;      Deggendorf, Landkreis;Insgesamt;117281;57868;59413
09272;      Freyung-Grafenau, Landkreis;unter 3 Jahre;1648;838;810
09272;      Freyung-Grafenau, Landkreis;3 bis unter 6 Jahre;1802;952;850
09272;      Freyung-Grafenau, Landkreis;6 bis unter 10 Jahre;2811;1452;1359
09272;      Freyung-Grafenau, Landkreis;10 bis unter 15 Jahre;4285;2200;2085
09272;      Freyung-Grafenau, Landkreis;15 bis unter 18 Jahre;2760;1430;1330
09272;      Freyung-Grafenau, Landkreis;18 bis unter 20 Jahre;1999;991;1008
09272;      Freyung-Grafenau, Landkreis;20 bis unter 25 Jahre;4688;2472;2216
09272;      Freyung-Grafenau, Landkreis;25 bis unter 30 Jahre;4312;2201;2111
09272;      Freyung-Grafenau, Landkreis;30 bis unter 35 Jahre;4125;2135;1990
09272;      Freyung-Grafenau, Landkreis;35 bis unter 40 Jahre;4650;2310;2340
09272;      Freyung-Grafenau, Landkreis;40 bis unter 45 Jahre;6127;3093;3034
09272;      Freyung-Grafenau, Landkreis;45 bis unter 50 Jahre;6880;3408;3472
09272;      Freyung-Grafenau, Landkreis;50 bis unter 55 Jahre;6927;3545;3382
09272;      Freyung-Grafenau, Landkreis;55 bis unter 60 Jahre;5867;3007;2860
09272;      Freyung-Grafenau, Landkreis;60 bis unter 65 Jahre;4892;2562;2330
09272;      Freyung-Grafenau, Landkreis;65 bis unter 75 Jahre;7848;3741;4107
09272;      Freyung-Grafenau, Landkreis;75 Jahre und mehr;7548;2787;4761
09272;      Freyung-Grafenau, Landkreis;Insgesamt;79169;39124;40045
09273;      Kelheim, Landkreis;unter 3 Jahre;3064;1566;1498
09273;      Kelheim, Landkreis;3 bis unter 6 Jahre;3223;1670;1553
09273;      Kelheim, Landkreis;6 bis unter 10 Jahre;4546;2296;2250
09273;      Kelheim, Landkreis;10 bis unter 15 Jahre;6283;3184;3099
09273;      Kelheim, Landkreis;15 bis unter 18 Jahre;4014;2067;1947
09273;      Kelheim, Landkreis;18 bis unter 20 Jahre;2820;1460;1360
09273;      Kelheim, Landkreis;20 bis unter 25 Jahre;6866;3681;3185
09273;      Kelheim, Landkreis;25 bis unter 30 Jahre;6520;3371;3149
09273;      Kelheim, Landkreis;30 bis unter 35 Jahre;6629;3309;3320
09273;      Kelheim, Landkreis;35 bis unter 40 Jahre;7182;3629;3553
09273;      Kelheim, Landkreis;40 bis unter 45 Jahre;9253;4723;4530
09273;      Kelheim, Landkreis;45 bis unter 50 Jahre;10047;5230;4817
09273;      Kelheim, Landkreis;50 bis unter 55 Jahre;8991;4613;4378
09273;      Kelheim, Landkreis;55 bis unter 60 Jahre;7670;3826;3844
09273;      Kelheim, Landkreis;60 bis unter 65 Jahre;6379;3235;3144
09273;      Kelheim, Landkreis;65 bis unter 75 Jahre;10705;5234;5471
09273;      Kelheim, Landkreis;75 Jahre und mehr;9567;3692;5875
09273;      Kelheim, Landkreis;Insgesamt;113759;56786;56973
09274;      Landshut, Landkreis;unter 3 Jahre;3871;1975;1896
09274;      Landshut, Landkreis;3 bis unter 6 Jahre;4196;2149;2047
09274;      Landshut, Landkreis;6 bis unter 10 Jahre;5825;2972;2853
09274;      Landshut, Landkreis;10 bis unter 15 Jahre;8526;4350;4176
09274;      Landshut, Landkreis;15 bis unter 18 Jahre;5264;2743;2521
09274;      Landshut, Landkreis;18 bis unter 20 Jahre;3635;1886;1749
09274;      Landshut, Landkreis;20 bis unter 25 Jahre;8814;4730;4084
09274;      Landshut, Landkreis;25 bis unter 30 Jahre;8056;4212;3844
09274;      Landshut, Landkreis;30 bis unter 35 Jahre;8583;4309;4274
09274;      Landshut, Landkreis;35 bis unter 40 Jahre;9383;4711;4672
09274;      Landshut, Landkreis;40 bis unter 45 Jahre;12615;6478;6137
09274;      Landshut, Landkreis;45 bis unter 50 Jahre;13954;7181;6773
09274;      Landshut, Landkreis;50 bis unter 55 Jahre;12362;6362;6000
09274;      Landshut, Landkreis;55 bis unter 60 Jahre;9851;4956;4895
09274;      Landshut, Landkreis;60 bis unter 65 Jahre;8700;4433;4267
09274;      Landshut, Landkreis;65 bis unter 75 Jahre;14279;7044;7235
09274;      Landshut, Landkreis;75 Jahre und mehr;11500;4562;6938
09274;      Landshut, Landkreis;Insgesamt;149414;75053;74361
09275;      Passau, Landkreis;unter 3 Jahre;4323;2191;2132
09275;      Passau, Landkreis;3 bis unter 6 Jahre;4460;2326;2134
09275;      Passau, Landkreis;6 bis unter 10 Jahre;6697;3524;3173
09275;      Passau, Landkreis;10 bis unter 15 Jahre;9823;5063;4760
09275;      Passau, Landkreis;15 bis unter 18 Jahre;6344;3229;3115
09275;      Passau, Landkreis;18 bis unter 20 Jahre;4370;2273;2097
09275;      Passau, Landkreis;20 bis unter 25 Jahre;10853;5616;5237
09275;      Passau, Landkreis;25 bis unter 30 Jahre;10099;5069;5030
09275;      Passau, Landkreis;30 bis unter 35 Jahre;10523;5380;5143
09275;      Passau, Landkreis;35 bis unter 40 Jahre;11154;5716;5438
09275;      Passau, Landkreis;40 bis unter 45 Jahre;14868;7585;7283
09275;      Passau, Landkreis;45 bis unter 50 Jahre;16263;8254;8009
09275;      Passau, Landkreis;50 bis unter 55 Jahre;15484;7772;7712
09275;      Passau, Landkreis;55 bis unter 60 Jahre;13035;6491;6544
09275;      Passau, Landkreis;60 bis unter 65 Jahre;11674;5815;5859
09275;      Passau, Landkreis;65 bis unter 75 Jahre;19699;9425;10274
09275;      Passau, Landkreis;75 Jahre und mehr;17941;6735;11206
09275;      Passau, Landkreis;Insgesamt;187610;92464;95146
09276;      Regen, Landkreis;unter 3 Jahre;1655;889;766
09276;      Regen, Landkreis;3 bis unter 6 Jahre;1757;923;834
09276;      Regen, Landkreis;6 bis unter 10 Jahre;2688;1396;1292
09276;      Regen, Landkreis;10 bis unter 15 Jahre;3974;2053;1921
09276;      Regen, Landkreis;15 bis unter 18 Jahre;2488;1268;1220
09276;      Regen, Landkreis;18 bis unter 20 Jahre;1776;939;837
09276;      Regen, Landkreis;20 bis unter 25 Jahre;4653;2514;2139
09276;      Regen, Landkreis;25 bis unter 30 Jahre;4309;2269;2040
09276;      Regen, Landkreis;30 bis unter 35 Jahre;4344;2252;2092
09276;      Regen, Landkreis;35 bis unter 40 Jahre;4605;2418;2187
09276;      Regen, Landkreis;40 bis unter 45 Jahre;6139;3202;2937
09276;      Regen, Landkreis;45 bis unter 50 Jahre;6632;3323;3309
09276;      Regen, Landkreis;50 bis unter 55 Jahre;6778;3479;3299
09276;      Regen, Landkreis;55 bis unter 60 Jahre;5723;2925;2798
09276;      Regen, Landkreis;60 bis unter 65 Jahre;5209;2656;2553
09276;      Regen, Landkreis;65 bis unter 75 Jahre;8159;3871;4288
09276;      Regen, Landkreis;75 Jahre und mehr;7564;2779;4785
09276;      Regen, Landkreis;Insgesamt;78453;39156;39297
09277;      Rottal-Inn, Landkreis;unter 3 Jahre;2817;1479;1338
09277;      Rottal-Inn, Landkreis;3 bis unter 6 Jahre;2989;1516;1473
09277;      Rottal-Inn, Landkreis;6 bis unter 10 Jahre;4299;2193;2106
09277;      Rottal-Inn, Landkreis;10 bis unter 15 Jahre;6395;3307;3088
09277;      Rottal-Inn, Landkreis;15 bis unter 18 Jahre;4221;2183;2038
09277;      Rottal-Inn, Landkreis;18 bis unter 20 Jahre;2836;1462;1374
09277;      Rottal-Inn, Landkreis;20 bis unter 25 Jahre;6847;3638;3209
09277;      Rottal-Inn, Landkreis;25 bis unter 30 Jahre;6473;3372;3101
09277;      Rottal-Inn, Landkreis;30 bis unter 35 Jahre;6527;3316;3211
09277;      Rottal-Inn, Landkreis;35 bis unter 40 Jahre;6739;3456;3283
09277;      Rottal-Inn, Landkreis;40 bis unter 45 Jahre;9260;4780;4480
09277;      Rottal-Inn, Landkreis;45 bis unter 50 Jahre;10028;5136;4892
09277;      Rottal-Inn, Landkreis;50 bis unter 55 Jahre;9643;4780;4863
09277;      Rottal-Inn, Landkreis;55 bis unter 60 Jahre;7808;3950;3858
09277;      Rottal-Inn, Landkreis;60 bis unter 65 Jahre;6929;3469;3460
09277;      Rottal-Inn, Landkreis;65 bis unter 75 Jahre;12375;5962;6413
09277;      Rottal-Inn, Landkreis;75 Jahre und mehr;11825;4477;7348
09277;      Rottal-Inn, Landkreis;Insgesamt;118011;58476;59535
09278;      Straubing-Bogen, Landkreis;unter 3 Jahre;2376;1215;1161
09278;      Straubing-Bogen, Landkreis;3 bis unter 6 Jahre;2588;1290;1298
09278;      Straubing-Bogen, Landkreis;6 bis unter 10 Jahre;3845;2016;1829
09278;      Straubing-Bogen, Landkreis;10 bis unter 15 Jahre;5622;2913;2709
09278;      Straubing-Bogen, Landkreis;15 bis unter 18 Jahre;3290;1652;1638
09278;      Straubing-Bogen, Landkreis;18 bis unter 20 Jahre;2350;1220;1130
09278;      Straubing-Bogen, Landkreis;20 bis unter 25 Jahre;5774;3120;2654
09278;      Straubing-Bogen, Landkreis;25 bis unter 30 Jahre;5246;2741;2505
09278;      Straubing-Bogen, Landkreis;30 bis unter 35 Jahre;5247;2612;2635
09278;      Straubing-Bogen, Landkreis;35 bis unter 40 Jahre;6051;2955;3096
09278;      Straubing-Bogen, Landkreis;40 bis unter 45 Jahre;8361;4254;4107
09278;      Straubing-Bogen, Landkreis;45 bis unter 50 Jahre;8879;4619;4260
09278;      Straubing-Bogen, Landkreis;50 bis unter 55 Jahre;8129;4184;3945
09278;      Straubing-Bogen, Landkreis;55 bis unter 60 Jahre;6755;3484;3271
09278;      Straubing-Bogen, Landkreis;60 bis unter 65 Jahre;5803;2876;2927
09278;      Straubing-Bogen, Landkreis;65 bis unter 75 Jahre;9297;4556;4741
09278;      Straubing-Bogen, Landkreis;75 Jahre und mehr;8225;3090;5135
09278;      Straubing-Bogen, Landkreis;Insgesamt;97838;48797;49041
09279;      Dingolfing-Landau, Landkreis;unter 3 Jahre;2151;1080;1071
09279;      Dingolfing-Landau, Landkreis;3 bis unter 6 Jahre;2336;1221;1115
09279;      Dingolfing-Landau, Landkreis;6 bis unter 10 Jahre;3378;1713;1665
09279;      Dingolfing-Landau, Landkreis;10 bis unter 15 Jahre;4904;2531;2373
09279;      Dingolfing-Landau, Landkreis;15 bis unter 18 Jahre;3114;1642;1472
09279;      Dingolfing-Landau, Landkreis;18 bis unter 20 Jahre;2218;1157;1061
09279;      Dingolfing-Landau, Landkreis;20 bis unter 25 Jahre;5905;3294;2611
09279;      Dingolfing-Landau, Landkreis;25 bis unter 30 Jahre;5455;2897;2558
09279;      Dingolfing-Landau, Landkreis;30 bis unter 35 Jahre;5248;2754;2494
09279;      Dingolfing-Landau, Landkreis;35 bis unter 40 Jahre;5443;2831;2612
09279;      Dingolfing-Landau, Landkreis;40 bis unter 45 Jahre;7308;3757;3551
09279;      Dingolfing-Landau, Landkreis;45 bis unter 50 Jahre;7988;4112;3876
09279;      Dingolfing-Landau, Landkreis;50 bis unter 55 Jahre;7792;4001;3791
09279;      Dingolfing-Landau, Landkreis;55 bis unter 60 Jahre;6144;3145;2999
09279;      Dingolfing-Landau, Landkreis;60 bis unter 65 Jahre;5393;2725;2668
09279;      Dingolfing-Landau, Landkreis;65 bis unter 75 Jahre;8791;4284;4507
09279;      Dingolfing-Landau, Landkreis;75 Jahre und mehr;7910;3154;4756
09279;      Dingolfing-Landau, Landkreis;Insgesamt;91478;46298;45180
093;    Oberpfalz, Regierungsbezirk;unter 3 Jahre;25717;13168;12549
093;    Oberpfalz, Regierungsbezirk;3 bis unter 6 Jahre;26699;13703;12996
093;    Oberpfalz, Regierungsbezirk;6 bis unter 10 Jahre;37752;19308;18444
093;    Oberpfalz, Regierungsbezirk;10 bis unter 15 Jahre;55973;28682;27291
093;    Oberpfalz, Regierungsbezirk;15 bis unter 18 Jahre;35638;18237;17401
093;    Oberpfalz, Regierungsbezirk;18 bis unter 20 Jahre;25505;13102;12403
093;    Oberpfalz, Regierungsbezirk;20 bis unter 25 Jahre;67805;35074;32731
093;    Oberpfalz, Regierungsbezirk;25 bis unter 30 Jahre;65059;33385;31674
093;    Oberpfalz, Regierungsbezirk;30 bis unter 35 Jahre;63877;32365;31512
093;    Oberpfalz, Regierungsbezirk;35 bis unter 40 Jahre;64516;32672;31844
093;    Oberpfalz, Regierungsbezirk;40 bis unter 45 Jahre;85528;43511;42017
093;    Oberpfalz, Regierungsbezirk;45 bis unter 50 Jahre;96367;49093;47274
093;    Oberpfalz, Regierungsbezirk;50 bis unter 55 Jahre;88320;45188;43132
093;    Oberpfalz, Regierungsbezirk;55 bis unter 60 Jahre;73611;37332;36279
093;    Oberpfalz, Regierungsbezirk;60 bis unter 65 Jahre;63076;31904;31172
093;    Oberpfalz, Regierungsbezirk;65 bis unter 75 Jahre;106902;50545;56357
093;    Oberpfalz, Regierungsbezirk;75 Jahre und mehr;99191;37177;62014
093;    Oberpfalz, Regierungsbezirk;Insgesamt;1081536;534446;547090
09361;      Amberg;unter 3 Jahre;980;519;461
09361;      Amberg;3 bis unter 6 Jahre;986;538;448
09361;      Amberg;6 bis unter 10 Jahre;1384;698;686
09361;      Amberg;10 bis unter 15 Jahre;1945;991;954
09361;      Amberg;15 bis unter 18 Jahre;1242;633;609
09361;      Amberg;18 bis unter 20 Jahre;939;521;418
09361;      Amberg;20 bis unter 25 Jahre;2795;1477;1318
09361;      Amberg;25 bis unter 30 Jahre;2776;1544;1232
09361;      Amberg;30 bis unter 35 Jahre;2544;1375;1169
09361;      Amberg;35 bis unter 40 Jahre;2431;1219;1212
09361;      Amberg;40 bis unter 45 Jahre;3217;1559;1658
09361;      Amberg;45 bis unter 50 Jahre;3691;1868;1823
09361;      Amberg;50 bis unter 55 Jahre;3306;1620;1686
09361;      Amberg;55 bis unter 60 Jahre;2991;1473;1518
09361;      Amberg;60 bis unter 65 Jahre;2698;1305;1393
09361;      Amberg;65 bis unter 75 Jahre;4740;2114;2626
09361;      Amberg;75 Jahre und mehr;4864;1739;3125
09361;      Amberg;Insgesamt;43529;21193;22336
09362;      Regensburg, Stadt;unter 3 Jahre;3690;1817;1873
09362;      Regensburg, Stadt;3 bis unter 6 Jahre;3521;1780;1741
09362;      Regensburg, Stadt;6 bis unter 10 Jahre;4055;2053;2002
09362;      Regensburg, Stadt;10 bis unter 15 Jahre;5059;2638;2421
09362;      Regensburg, Stadt;15 bis unter 18 Jahre;3000;1503;1497
09362;      Regensburg, Stadt;18 bis unter 20 Jahre;2612;1258;1354
09362;      Regensburg, Stadt;20 bis unter 25 Jahre;10245;4781;5464
09362;      Regensburg, Stadt;25 bis unter 30 Jahre;12307;6025;6282
09362;      Regensburg, Stadt;30 bis unter 35 Jahre;11073;5614;5459
09362;      Regensburg, Stadt;35 bis unter 40 Jahre;9123;4829;4294
09362;      Regensburg, Stadt;40 bis unter 45 Jahre;10435;5494;4941
09362;      Regensburg, Stadt;45 bis unter 50 Jahre;11808;6012;5796
09362;      Regensburg, Stadt;50 bis unter 55 Jahre;9813;4939;4874
09362;      Regensburg, Stadt;55 bis unter 60 Jahre;7716;3715;4001
09362;      Regensburg, Stadt;60 bis unter 65 Jahre;6863;3238;3625
09362;      Regensburg, Stadt;65 bis unter 75 Jahre;13081;5785;7296
09362;      Regensburg, Stadt;75 Jahre und mehr;12176;4279;7897
09362;      Regensburg, Stadt;Insgesamt;136577;65760;70817
09363;      Weiden i.d.OPf.;unter 3 Jahre;933;459;474
09363;      Weiden i.d.OPf.;3 bis unter 6 Jahre;958;465;493
09363;      Weiden i.d.OPf.;6 bis unter 10 Jahre;1343;662;681
09363;      Weiden i.d.OPf.;10 bis unter 15 Jahre;2040;1041;999
09363;      Weiden i.d.OPf.;15 bis unter 18 Jahre;1317;677;640
09363;      Weiden i.d.OPf.;18 bis unter 20 Jahre;960;489;471
09363;      Weiden i.d.OPf.;20 bis unter 25 Jahre;2644;1311;1333
09363;      Weiden i.d.OPf.;25 bis unter 30 Jahre;2506;1288;1218
09363;      Weiden i.d.OPf.;30 bis unter 35 Jahre;2420;1185;1235
09363;      Weiden i.d.OPf.;35 bis unter 40 Jahre;2390;1155;1235
09363;      Weiden i.d.OPf.;40 bis unter 45 Jahre;3234;1689;1545
09363;      Weiden i.d.OPf.;45 bis unter 50 Jahre;3363;1679;1684
09363;      Weiden i.d.OPf.;50 bis unter 55 Jahre;3216;1599;1617
09363;      Weiden i.d.OPf.;55 bis unter 60 Jahre;2696;1285;1411
09363;      Weiden i.d.OPf.;60 bis unter 65 Jahre;2560;1208;1352
09363;      Weiden i.d.OPf.;65 bis unter 75 Jahre;4911;2206;2705
09363;      Weiden i.d.OPf.;75 Jahre und mehr;4463;1529;2934
09363;      Weiden i.d.OPf.;Insgesamt;41954;19927;22027
09371;      Amberg-Sulzbach, Landkreis;unter 3 Jahre;2314;1182;1132
09371;      Amberg-Sulzbach, Landkreis;3 bis unter 6 Jahre;2469;1312;1157
09371;      Amberg-Sulzbach, Landkreis;6 bis unter 10 Jahre;3719;1942;1777
09371;      Amberg-Sulzbach, Landkreis;10 bis unter 15 Jahre;5743;2930;2813
09371;      Amberg-Sulzbach, Landkreis;15 bis unter 18 Jahre;3732;1897;1835
09371;      Amberg-Sulzbach, Landkreis;18 bis unter 20 Jahre;2489;1298;1191
09371;      Amberg-Sulzbach, Landkreis;20 bis unter 25 Jahre;6588;3444;3144
09371;      Amberg-Sulzbach, Landkreis;25 bis unter 30 Jahre;5699;2910;2789
09371;      Amberg-Sulzbach, Landkreis;30 bis unter 35 Jahre;5509;2787;2722
09371;      Amberg-Sulzbach, Landkreis;35 bis unter 40 Jahre;5821;2895;2926
09371;      Amberg-Sulzbach, Landkreis;40 bis unter 45 Jahre;8196;4058;4138
09371;      Amberg-Sulzbach, Landkreis;45 bis unter 50 Jahre;9511;4881;4630
09371;      Amberg-Sulzbach, Landkreis;50 bis unter 55 Jahre;9052;4623;4429
09371;      Amberg-Sulzbach, Landkreis;55 bis unter 60 Jahre;7335;3845;3490
09371;      Amberg-Sulzbach, Landkreis;60 bis unter 65 Jahre;5996;3080;2916
09371;      Amberg-Sulzbach, Landkreis;65 bis unter 75 Jahre;10433;4949;5484
09371;      Amberg-Sulzbach, Landkreis;75 Jahre und mehr;10103;3988;6115
09371;      Amberg-Sulzbach, Landkreis;Insgesamt;104709;52021;52688
09372;      Cham, Landkreis;unter 3 Jahre;2886;1441;1445
09372;      Cham, Landkreis;3 bis unter 6 Jahre;3031;1534;1497
09372;      Cham, Landkreis;6 bis unter 10 Jahre;4460;2284;2176
09372;      Cham, Landkreis;10 bis unter 15 Jahre;6719;3431;3288
09372;      Cham, Landkreis;15 bis unter 18 Jahre;4372;2211;2161
09372;      Cham, Landkreis;18 bis unter 20 Jahre;2962;1519;1443
09372;      Cham, Landkreis;20 bis unter 25 Jahre;7786;4094;3692
09372;      Cham, Landkreis;25 bis unter 30 Jahre;7254;3807;3447
09372;      Cham, Landkreis;30 bis unter 35 Jahre;7161;3712;3449
09372;      Cham, Landkreis;35 bis unter 40 Jahre;7549;3816;3733
09372;      Cham, Landkreis;40 bis unter 45 Jahre;9996;5122;4874
09372;      Cham, Landkreis;45 bis unter 50 Jahre;11272;5733;5539
09372;      Cham, Landkreis;50 bis unter 55 Jahre;10753;5478;5275
09372;      Cham, Landkreis;55 bis unter 60 Jahre;9077;4715;4362
09372;      Cham, Landkreis;60 bis unter 65 Jahre;7783;4044;3739
09372;      Cham, Landkreis;65 bis unter 75 Jahre;12788;6297;6491
09372;      Cham, Landkreis;75 Jahre und mehr;12144;4576;7568
09372;      Cham, Landkreis;Insgesamt;127993;63814;64179
09373;      Neumarkt i.d.OPf., Landkreis;unter 3 Jahre;3213;1643;1570
09373;      Neumarkt i.d.OPf., Landkreis;3 bis unter 6 Jahre;3343;1727;1616
09373;      Neumarkt i.d.OPf., Landkreis;6 bis unter 10 Jahre;4713;2391;2322
09373;      Neumarkt i.d.OPf., Landkreis;10 bis unter 15 Jahre;7379;3813;3566
09373;      Neumarkt i.d.OPf., Landkreis;15 bis unter 18 Jahre;4741;2446;2295
09373;      Neumarkt i.d.OPf., Landkreis;18 bis unter 20 Jahre;3350;1709;1641
09373;      Neumarkt i.d.OPf., Landkreis;20 bis unter 25 Jahre;8001;4294;3707
09373;      Neumarkt i.d.OPf., Landkreis;25 bis unter 30 Jahre;7033;3614;3419
09373;      Neumarkt i.d.OPf., Landkreis;30 bis unter 35 Jahre;7188;3643;3545
09373;      Neumarkt i.d.OPf., Landkreis;35 bis unter 40 Jahre;7663;3877;3786
09373;      Neumarkt i.d.OPf., Landkreis;40 bis unter 45 Jahre;10556;5300;5256
09373;      Neumarkt i.d.OPf., Landkreis;45 bis unter 50 Jahre;11675;5952;5723
09373;      Neumarkt i.d.OPf., Landkreis;50 bis unter 55 Jahre;10570;5465;5105
09373;      Neumarkt i.d.OPf., Landkreis;55 bis unter 60 Jahre;8722;4484;4238
09373;      Neumarkt i.d.OPf., Landkreis;60 bis unter 65 Jahre;7148;3723;3425
09373;      Neumarkt i.d.OPf., Landkreis;65 bis unter 75 Jahre;11895;5681;6214
09373;      Neumarkt i.d.OPf., Landkreis;75 Jahre und mehr;10734;4114;6620
09373;      Neumarkt i.d.OPf., Landkreis;Insgesamt;127924;63876;64048
09374;      Neustadt a.d.Waldnaab, Landkreis;unter 3 Jahre;2126;1126;1000
09374;      Neustadt a.d.Waldnaab, Landkreis;3 bis unter 6 Jahre;2347;1225;1122
09374;      Neustadt a.d.Waldnaab, Landkreis;6 bis unter 10 Jahre;3490;1763;1727
09374;      Neustadt a.d.Waldnaab, Landkreis;10 bis unter 15 Jahre;5396;2697;2699
09374;      Neustadt a.d.Waldnaab, Landkreis;15 bis unter 18 Jahre;3454;1782;1672
09374;      Neustadt a.d.Waldnaab, Landkreis;18 bis unter 20 Jahre;2468;1262;1206
09374;      Neustadt a.d.Waldnaab, Landkreis;20 bis unter 25 Jahre;5909;3124;2785
09374;      Neustadt a.d.Waldnaab, Landkreis;25 bis unter 30 Jahre;5396;2803;2593
09374;      Neustadt a.d.Waldnaab, Landkreis;30 bis unter 35 Jahre;5362;2721;2641
09374;      Neustadt a.d.Waldnaab, Landkreis;35 bis unter 40 Jahre;5541;2779;2762
09374;      Neustadt a.d.Waldnaab, Landkreis;40 bis unter 45 Jahre;7707;3765;3942
09374;      Neustadt a.d.Waldnaab, Landkreis;45 bis unter 50 Jahre;8567;4387;4180
09374;      Neustadt a.d.Waldnaab, Landkreis;50 bis unter 55 Jahre;8121;4193;3928
09374;      Neustadt a.d.Waldnaab, Landkreis;55 bis unter 60 Jahre;6801;3533;3268
09374;      Neustadt a.d.Waldnaab, Landkreis;60 bis unter 65 Jahre;5713;2940;2773
09374;      Neustadt a.d.Waldnaab, Landkreis;65 bis unter 75 Jahre;9372;4427;4945
09374;      Neustadt a.d.Waldnaab, Landkreis;75 Jahre und mehr;8991;3429;5562
09374;      Neustadt a.d.Waldnaab, Landkreis;Insgesamt;96761;47956;48805
09375;      Regensburg, Landkreis;unter 3 Jahre;4660;2455;2205
09375;      Regensburg, Landkreis;3 bis unter 6 Jahre;4918;2543;2375
09375;      Regensburg, Landkreis;6 bis unter 10 Jahre;7027;3603;3424
09375;      Regensburg, Landkreis;10 bis unter 15 Jahre;10120;5166;4954
09375;      Regensburg, Landkreis;15 bis unter 18 Jahre;6296;3253;3043
09375;      Regensburg, Landkreis;18 bis unter 20 Jahre;4418;2276;2142
09375;      Regensburg, Landkreis;20 bis unter 25 Jahre;10707;5565;5142
09375;      Regensburg, Landkreis;25 bis unter 30 Jahre;10109;5191;4918
09375;      Regensburg, Landkreis;30 bis unter 35 Jahre;10598;5282;5316
09375;      Regensburg, Landkreis;35 bis unter 40 Jahre;11455;5656;5799
09375;      Regensburg, Landkreis;40 bis unter 45 Jahre;15213;7781;7432
09375;      Regensburg, Landkreis;45 bis unter 50 Jahre;17298;8772;8526
09375;      Regensburg, Landkreis;50 bis unter 55 Jahre;15841;8070;7771
09375;      Regensburg, Landkreis;55 bis unter 60 Jahre;12999;6455;6544
09375;      Regensburg, Landkreis;60 bis unter 65 Jahre;11291;5749;5542
09375;      Regensburg, Landkreis;65 bis unter 75 Jahre;17658;8666;8992
09375;      Regensburg, Landkreis;75 Jahre und mehr;14237;5531;8706
09375;      Regensburg, Landkreis;Insgesamt;184845;92014;92831
09376;      Schwandorf, Landkreis;unter 3 Jahre;3275;1709;1566
09376;      Schwandorf, Landkreis;3 bis unter 6 Jahre;3446;1710;1736
09376;      Schwandorf, Landkreis;6 bis unter 10 Jahre;5078;2635;2443
09376;      Schwandorf, Landkreis;10 bis unter 15 Jahre;7647;3971;3676
09376;      Schwandorf, Landkreis;15 bis unter 18 Jahre;4806;2484;2322
09376;      Schwandorf, Landkreis;18 bis unter 20 Jahre;3443;1807;1636
09376;      Schwandorf, Landkreis;20 bis unter 25 Jahre;8827;4653;4174
09376;      Schwandorf, Landkreis;25 bis unter 30 Jahre;8090;4176;3914
09376;      Schwandorf, Landkreis;30 bis unter 35 Jahre;8193;4160;4033
09376;      Schwandorf, Landkreis;35 bis unter 40 Jahre;8441;4364;4077
09376;      Schwandorf, Landkreis;40 bis unter 45 Jahre;11285;5824;5461
09376;      Schwandorf, Landkreis;45 bis unter 50 Jahre;12772;6565;6207
09376;      Schwandorf, Landkreis;50 bis unter 55 Jahre;11533;6064;5469
09376;      Schwandorf, Landkreis;55 bis unter 60 Jahre;9977;5100;4877
09376;      Schwandorf, Landkreis;60 bis unter 65 Jahre;8411;4237;4174
09376;      Schwandorf, Landkreis;65 bis unter 75 Jahre;14146;6707;7439
09376;      Schwandorf, Landkreis;75 Jahre und mehr;13548;5040;8508
09376;      Schwandorf, Landkreis;Insgesamt;142918;71206;71712
09377;      Tirschenreuth, Landkreis;unter 3 Jahre;1640;817;823
09377;      Tirschenreuth, Landkreis;3 bis unter 6 Jahre;1680;869;811
09377;      Tirschenreuth, Landkreis;6 bis unter 10 Jahre;2483;1277;1206
09377;      Tirschenreuth, Landkreis;10 bis unter 15 Jahre;3925;2004;1921
09377;      Tirschenreuth, Landkreis;15 bis unter 18 Jahre;2678;1351;1327
09377;      Tirschenreuth, Landkreis;18 bis unter 20 Jahre;1864;963;901
09377;      Tirschenreuth, Landkreis;20 bis unter 25 Jahre;4303;2331;1972
09377;      Tirschenreuth, Landkreis;25 bis unter 30 Jahre;3889;2027;1862
09377;      Tirschenreuth, Landkreis;30 bis unter 35 Jahre;3829;1886;1943
09377;      Tirschenreuth, Landkreis;35 bis unter 40 Jahre;4102;2082;2020
09377;      Tirschenreuth, Landkreis;40 bis unter 45 Jahre;5689;2919;2770
09377;      Tirschenreuth, Landkreis;45 bis unter 50 Jahre;6410;3244;3166
09377;      Tirschenreuth, Landkreis;50 bis unter 55 Jahre;6115;3137;2978
09377;      Tirschenreuth, Landkreis;55 bis unter 60 Jahre;5297;2727;2570
09377;      Tirschenreuth, Landkreis;60 bis unter 65 Jahre;4613;2380;2233
09377;      Tirschenreuth, Landkreis;65 bis unter 75 Jahre;7878;3713;4165
09377;      Tirschenreuth, Landkreis;75 Jahre und mehr;7931;2952;4979
09377;      Tirschenreuth, Landkreis;Insgesamt;74326;36679;37647
094;    Oberfranken, Regierungsbezirk;unter 3 Jahre;23554;12020;11534
094;    Oberfranken, Regierungsbezirk;3 bis unter 6 Jahre;24924;12656;12268
094;    Oberfranken, Regierungsbezirk;6 bis unter 10 Jahre;35765;18108;17657
094;    Oberfranken, Regierungsbezirk;10 bis unter 15 Jahre;52496;27257;25239
094;    Oberfranken, Regierungsbezirk;15 bis unter 18 Jahre;33335;17006;16329
094;    Oberfranken, Regierungsbezirk;18 bis unter 20 Jahre;24679;12747;11932
094;    Oberfranken, Regierungsbezirk;20 bis unter 25 Jahre;65753;33878;31875
094;    Oberfranken, Regierungsbezirk;25 bis unter 30 Jahre;59308;30197;29111
094;    Oberfranken, Regierungsbezirk;30 bis unter 35 Jahre;57274;28872;28402
094;    Oberfranken, Regierungsbezirk;35 bis unter 40 Jahre;59398;29364;30034
094;    Oberfranken, Regierungsbezirk;40 bis unter 45 Jahre;83561;41790;41771
094;    Oberfranken, Regierungsbezirk;45 bis unter 50 Jahre;93686;47660;46026
094;    Oberfranken, Regierungsbezirk;50 bis unter 55 Jahre;87816;44600;43216
094;    Oberfranken, Regierungsbezirk;55 bis unter 60 Jahre;73904;36935;36969
094;    Oberfranken, Regierungsbezirk;60 bis unter 65 Jahre;66226;32888;33338
094;    Oberfranken, Regierungsbezirk;65 bis unter 75 Jahre;115701;54613;61088
094;    Oberfranken, Regierungsbezirk;75 Jahre und mehr;110028;40646;69382
094;    Oberfranken, Regierungsbezirk;Insgesamt;1067408;521237;546171
09461;      Bamberg, Stadt;unter 3 Jahre;1696;876;820
09461;      Bamberg, Stadt;3 bis unter 6 Jahre;1651;818;833
09461;      Bamberg, Stadt;6 bis unter 10 Jahre;2084;1048;1036
09461;      Bamberg, Stadt;10 bis unter 15 Jahre;2659;1371;1288
09461;      Bamberg, Stadt;15 bis unter 18 Jahre;1852;921;931
09461;      Bamberg, Stadt;18 bis unter 20 Jahre;1426;688;738
09461;      Bamberg, Stadt;20 bis unter 25 Jahre;5562;2455;3107
09461;      Bamberg, Stadt;25 bis unter 30 Jahre;5463;2593;2870
09461;      Bamberg, Stadt;30 bis unter 35 Jahre;4513;2256;2257
09461;      Bamberg, Stadt;35 bis unter 40 Jahre;4124;1981;2143
09461;      Bamberg, Stadt;40 bis unter 45 Jahre;5210;2562;2648
09461;      Bamberg, Stadt;45 bis unter 50 Jahre;5732;2797;2935
09461;      Bamberg, Stadt;50 bis unter 55 Jahre;5176;2598;2578
09461;      Bamberg, Stadt;55 bis unter 60 Jahre;4198;2002;2196
09461;      Bamberg, Stadt;60 bis unter 65 Jahre;3790;1796;1994
09461;      Bamberg, Stadt;65 bis unter 75 Jahre;7341;3300;4041
09461;      Bamberg, Stadt;75 Jahre und mehr;7607;2721;4886
09461;      Bamberg, Stadt;Insgesamt;70084;32783;37301
09462;      Bayreuth, Stadt;unter 3 Jahre;1495;741;754
09462;      Bayreuth, Stadt;3 bis unter 6 Jahre;1556;786;770
09462;      Bayreuth, Stadt;6 bis unter 10 Jahre;2053;1082;971
09462;      Bayreuth, Stadt;10 bis unter 15 Jahre;2797;1465;1332
09462;      Bayreuth, Stadt;15 bis unter 18 Jahre;1763;871;892
09462;      Bayreuth, Stadt;18 bis unter 20 Jahre;1847;936;911
09462;      Bayreuth, Stadt;20 bis unter 25 Jahre;7729;3852;3877
09462;      Bayreuth, Stadt;25 bis unter 30 Jahre;5679;3018;2661
09462;      Bayreuth, Stadt;30 bis unter 35 Jahre;4423;2327;2096
09462;      Bayreuth, Stadt;35 bis unter 40 Jahre;4027;2113;1914
09462;      Bayreuth, Stadt;40 bis unter 45 Jahre;4862;2437;2425
09462;      Bayreuth, Stadt;45 bis unter 50 Jahre;5846;2930;2916
09462;      Bayreuth, Stadt;50 bis unter 55 Jahre;5157;2617;2540
09462;      Bayreuth, Stadt;55 bis unter 60 Jahre;4542;2132;2410
09462;      Bayreuth, Stadt;60 bis unter 65 Jahre;4378;2058;2320
09462;      Bayreuth, Stadt;65 bis unter 75 Jahre;7846;3574;4272
09462;      Bayreuth, Stadt;75 Jahre und mehr;7111;2480;4631
09462;      Bayreuth, Stadt;Insgesamt;73111;35419;37692
09463;      Coburg, Stadt;unter 3 Jahre;874;439;435
09463;      Coburg, Stadt;3 bis unter 6 Jahre;967;475;492
09463;      Coburg, Stadt;6 bis unter 10 Jahre;1207;636;571
09463;      Coburg, Stadt;10 bis unter 15 Jahre;1789;929;860
09463;      Coburg, Stadt;15 bis unter 18 Jahre;1161;610;551
09463;      Coburg, Stadt;18 bis unter 20 Jahre;842;419;423
09463;      Coburg, Stadt;20 bis unter 25 Jahre;2689;1367;1322
09463;      Coburg, Stadt;25 bis unter 30 Jahre;2613;1345;1268
09463;      Coburg, Stadt;30 bis unter 35 Jahre;2131;1069;1062
09463;      Coburg, Stadt;35 bis unter 40 Jahre;2049;1017;1032
09463;      Coburg, Stadt;40 bis unter 45 Jahre;3118;1607;1511
09463;      Coburg, Stadt;45 bis unter 50 Jahre;3578;1802;1776
09463;      Coburg, Stadt;50 bis unter 55 Jahre;3340;1616;1724
09463;      Coburg, Stadt;55 bis unter 60 Jahre;2689;1280;1409
09463;      Coburg, Stadt;60 bis unter 65 Jahre;2503;1180;1323
09463;      Coburg, Stadt;65 bis unter 75 Jahre;4665;2156;2509
09463;      Coburg, Stadt;75 Jahre und mehr;4700;1653;3047
09463;      Coburg, Stadt;Insgesamt;40915;19600;21315
09464;      Hof, Stadt;unter 3 Jahre;1017;548;469
09464;      Hof, Stadt;3 bis unter 6 Jahre;995;495;500
09464;      Hof, Stadt;6 bis unter 10 Jahre;1456;741;715
09464;      Hof, Stadt;10 bis unter 15 Jahre;2116;1080;1036
09464;      Hof, Stadt;15 bis unter 18 Jahre;1249;644;605
09464;      Hof, Stadt;18 bis unter 20 Jahre;1007;496;511
09464;      Hof, Stadt;20 bis unter 25 Jahre;2733;1428;1305
09464;      Hof, Stadt;25 bis unter 30 Jahre;2592;1341;1251
09464;      Hof, Stadt;30 bis unter 35 Jahre;2499;1279;1220
09464;      Hof, Stadt;35 bis unter 40 Jahre;2421;1222;1199
09464;      Hof, Stadt;40 bis unter 45 Jahre;3371;1724;1647
09464;      Hof, Stadt;45 bis unter 50 Jahre;3670;1878;1792
09464;      Hof, Stadt;50 bis unter 55 Jahre;3472;1718;1754
09464;      Hof, Stadt;55 bis unter 60 Jahre;3223;1545;1678
09464;      Hof, Stadt;60 bis unter 65 Jahre;3100;1432;1668
09464;      Hof, Stadt;65 bis unter 75 Jahre;5640;2619;3021
09464;      Hof, Stadt;75 Jahre und mehr;5343;1824;3519
09464;      Hof, Stadt;Insgesamt;45904;22014;23890
09471;      Bamberg, Landkreis;unter 3 Jahre;3584;1807;1777
09471;      Bamberg, Landkreis;3 bis unter 6 Jahre;3782;1945;1837
09471;      Bamberg, Landkreis;6 bis unter 10 Jahre;5547;2763;2784
09471;      Bamberg, Landkreis;10 bis unter 15 Jahre;8096;4225;3871
09471;      Bamberg, Landkreis;15 bis unter 18 Jahre;5005;2565;2440
09471;      Bamberg, Landkreis;18 bis unter 20 Jahre;3595;1912;1683
09471;      Bamberg, Landkreis;20 bis unter 25 Jahre;8814;4657;4157
09471;      Bamberg, Landkreis;25 bis unter 30 Jahre;8287;4139;4148
09471;      Bamberg, Landkreis;30 bis unter 35 Jahre;8399;4144;4255
09471;      Bamberg, Landkreis;35 bis unter 40 Jahre;8781;4418;4363
09471;      Bamberg, Landkreis;40 bis unter 45 Jahre;11943;6017;5926
09471;      Bamberg, Landkreis;45 bis unter 50 Jahre;13367;6761;6606
09471;      Bamberg, Landkreis;50 bis unter 55 Jahre;12311;6371;5940
09471;      Bamberg, Landkreis;55 bis unter 60 Jahre;9933;5042;4891
09471;      Bamberg, Landkreis;60 bis unter 65 Jahre;8059;4174;3885
09471;      Bamberg, Landkreis;65 bis unter 75 Jahre;13283;6393;6890
09471;      Bamberg, Landkreis;75 Jahre und mehr;11575;4474;7101
09471;      Bamberg, Landkreis;Insgesamt;144361;71807;72554
09472;      Bayreuth, Landkreis;unter 3 Jahre;2440;1275;1165
09472;      Bayreuth, Landkreis;3 bis unter 6 Jahre;2557;1332;1225
09472;      Bayreuth, Landkreis;6 bis unter 10 Jahre;3764;1862;1902
09472;      Bayreuth, Landkreis;10 bis unter 15 Jahre;5569;2859;2710
09472;      Bayreuth, Landkreis;15 bis unter 18 Jahre;3575;1828;1747
09472;      Bayreuth, Landkreis;18 bis unter 20 Jahre;2468;1276;1192
09472;      Bayreuth, Landkreis;20 bis unter 25 Jahre;6048;3155;2893
09472;      Bayreuth, Landkreis;25 bis unter 30 Jahre;5290;2700;2590
09472;      Bayreuth, Landkreis;30 bis unter 35 Jahre;5476;2736;2740
09472;      Bayreuth, Landkreis;35 bis unter 40 Jahre;6172;3045;3127
09472;      Bayreuth, Landkreis;40 bis unter 45 Jahre;8751;4389;4362
09472;      Bayreuth, Landkreis;45 bis unter 50 Jahre;9421;4924;4497
09472;      Bayreuth, Landkreis;50 bis unter 55 Jahre;8900;4544;4356
09472;      Bayreuth, Landkreis;55 bis unter 60 Jahre;7397;3808;3589
09472;      Bayreuth, Landkreis;60 bis unter 65 Jahre;6557;3322;3235
09472;      Bayreuth, Landkreis;65 bis unter 75 Jahre;11158;5403;5755
09472;      Bayreuth, Landkreis;75 Jahre und mehr;10197;3764;6433
09472;      Bayreuth, Landkreis;Insgesamt;105740;52222;53518
09473;      Coburg, Landkreis;unter 3 Jahre;1834;925;909
09473;      Coburg, Landkreis;3 bis unter 6 Jahre;2047;1050;997
09473;      Coburg, Landkreis;6 bis unter 10 Jahre;2956;1511;1445
09473;      Coburg, Landkreis;10 bis unter 15 Jahre;4510;2381;2129
09473;      Coburg, Landkreis;15 bis unter 18 Jahre;2908;1499;1409
09473;      Coburg, Landkreis;18 bis unter 20 Jahre;2038;1068;970
09473;      Coburg, Landkreis;20 bis unter 25 Jahre;4907;2616;2291
09473;      Coburg, Landkreis;25 bis unter 30 Jahre;4488;2295;2193
09473;      Coburg, Landkreis;30 bis unter 35 Jahre;4427;2233;2194
09473;      Coburg, Landkreis;35 bis unter 40 Jahre;4598;2174;2424
09473;      Coburg, Landkreis;40 bis unter 45 Jahre;7061;3578;3483
09473;      Coburg, Landkreis;45 bis unter 50 Jahre;7893;4023;3870
09473;      Coburg, Landkreis;50 bis unter 55 Jahre;7356;3755;3601
09473;      Coburg, Landkreis;55 bis unter 60 Jahre;6233;3111;3122
09473;      Coburg, Landkreis;60 bis unter 65 Jahre;5691;2849;2842
09473;      Coburg, Landkreis;65 bis unter 75 Jahre;9624;4580;5044
09473;      Coburg, Landkreis;75 Jahre und mehr;9173;3561;5612
09473;      Coburg, Landkreis;Insgesamt;87744;43209;44535
09474;      Forchheim, Landkreis;unter 3 Jahre;2687;1378;1309
09474;      Forchheim, Landkreis;3 bis unter 6 Jahre;2953;1452;1501
09474;      Forchheim, Landkreis;6 bis unter 10 Jahre;4222;2126;2096
09474;      Forchheim, Landkreis;10 bis unter 15 Jahre;6172;3185;2987
09474;      Forchheim, Landkreis;15 bis unter 18 Jahre;3905;2019;1886
09474;      Forchheim, Landkreis;18 bis unter 20 Jahre;2865;1483;1382
09474;      Forchheim, Landkreis;20 bis unter 25 Jahre;6847;3569;3278
09474;      Forchheim, Landkreis;25 bis unter 30 Jahre;6155;3151;3004
09474;      Forchheim, Landkreis;30 bis unter 35 Jahre;6224;3160;3064
09474;      Forchheim, Landkreis;35 bis unter 40 Jahre;6327;3124;3203
09474;      Forchheim, Landkreis;40 bis unter 45 Jahre;8929;4407;4522
09474;      Forchheim, Landkreis;45 bis unter 50 Jahre;10625;5469;5156
09474;      Forchheim, Landkreis;50 bis unter 55 Jahre;9708;4900;4808
09474;      Forchheim, Landkreis;55 bis unter 60 Jahre;7857;4001;3856
09474;      Forchheim, Landkreis;60 bis unter 65 Jahre;6816;3438;3378
09474;      Forchheim, Landkreis;65 bis unter 75 Jahre;11198;5386;5812
09474;      Forchheim, Landkreis;75 Jahre und mehr;9717;3736;5981
09474;      Forchheim, Landkreis;Insgesamt;113207;55984;57223
09475;      Hof, Landkreis;unter 3 Jahre;1925;992;933
09475;      Hof, Landkreis;3 bis unter 6 Jahre;2107;1063;1044
09475;      Hof, Landkreis;6 bis unter 10 Jahre;3250;1678;1572
09475;      Hof, Landkreis;10 bis unter 15 Jahre;4904;2509;2395
09475;      Hof, Landkreis;15 bis unter 18 Jahre;3094;1558;1536
09475;      Hof, Landkreis;18 bis unter 20 Jahre;2180;1117;1063
09475;      Hof, Landkreis;20 bis unter 25 Jahre;5145;2730;2415
09475;      Hof, Landkreis;25 bis unter 30 Jahre;4403;2273;2130
09475;      Hof, Landkreis;30 bis unter 35 Jahre;4587;2285;2302
09475;      Hof, Landkreis;35 bis unter 40 Jahre;5178;2533;2645
09475;      Hof, Landkreis;40 bis unter 45 Jahre;7814;3856;3958
09475;      Hof, Landkreis;45 bis unter 50 Jahre;8552;4323;4229
09475;      Hof, Landkreis;50 bis unter 55 Jahre;8190;4150;4040
09475;      Hof, Landkreis;55 bis unter 60 Jahre;6975;3529;3446
09475;      Hof, Landkreis;60 bis unter 65 Jahre;6577;3200;3377
09475;      Hof, Landkreis;65 bis unter 75 Jahre;11958;5690;6268
09475;      Hof, Landkreis;75 Jahre und mehr;12297;4621;7676
09475;      Hof, Landkreis;Insgesamt;99136;48107;51029
09476;      Kronach, Landkreis;unter 3 Jahre;1467;732;735
09476;      Kronach, Landkreis;3 bis unter 6 Jahre;1447;742;705
09476;      Kronach, Landkreis;6 bis unter 10 Jahre;2213;1100;1113
09476;      Kronach, Landkreis;10 bis unter 15 Jahre;3370;1755;1615
09476;      Kronach, Landkreis;15 bis unter 18 Jahre;2052;1024;1028
09476;      Kronach, Landkreis;18 bis unter 20 Jahre;1550;811;739
09476;      Kronach, Landkreis;20 bis unter 25 Jahre;3668;1909;1759
09476;      Kronach, Landkreis;25 bis unter 30 Jahre;3445;1808;1637
09476;      Kronach, Landkreis;30 bis unter 35 Jahre;3567;1843;1724
09476;      Kronach, Landkreis;35 bis unter 40 Jahre;3895;1935;1960
09476;      Kronach, Landkreis;40 bis unter 45 Jahre;5561;2853;2708
09476;      Kronach, Landkreis;45 bis unter 50 Jahre;6240;3306;2934
09476;      Kronach, Landkreis;50 bis unter 55 Jahre;6045;3097;2948
09476;      Kronach, Landkreis;55 bis unter 60 Jahre;5126;2653;2473
09476;      Kronach, Landkreis;60 bis unter 65 Jahre;4453;2265;2188
09476;      Kronach, Landkreis;65 bis unter 75 Jahre;7797;3658;4139
09476;      Kronach, Landkreis;75 Jahre und mehr;7650;2835;4815
09476;      Kronach, Landkreis;Insgesamt;69546;34326;35220
09477;      Kulmbach, Landkreis;unter 3 Jahre;1528;777;751
09477;      Kulmbach, Landkreis;3 bis unter 6 Jahre;1732;925;807
09477;      Kulmbach, Landkreis;6 bis unter 10 Jahre;2489;1288;1201
09477;      Kulmbach, Landkreis;10 bis unter 15 Jahre;3659;1939;1720
09477;      Kulmbach, Landkreis;15 bis unter 18 Jahre;2295;1188;1107
09477;      Kulmbach, Landkreis;18 bis unter 20 Jahre;1606;847;759
09477;      Kulmbach, Landkreis;20 bis unter 25 Jahre;3925;2085;1840
09477;      Kulmbach, Landkreis;25 bis unter 30 Jahre;3686;1878;1808
09477;      Kulmbach, Landkreis;30 bis unter 35 Jahre;3797;1927;1870
09477;      Kulmbach, Landkreis;35 bis unter 40 Jahre;4206;1998;2208
09477;      Kulmbach, Landkreis;40 bis unter 45 Jahre;5853;2860;2993
09477;      Kulmbach, Landkreis;45 bis unter 50 Jahre;6390;3248;3142
09477;      Kulmbach, Landkreis;50 bis unter 55 Jahre;6187;3113;3074
09477;      Kulmbach, Landkreis;55 bis unter 60 Jahre;5371;2638;2733
09477;      Kulmbach, Landkreis;60 bis unter 65 Jahre;4949;2455;2494
09477;      Kulmbach, Landkreis;65 bis unter 75 Jahre;8183;3902;4281
09477;      Kulmbach, Landkreis;75 Jahre und mehr;8070;2907;5163
09477;      Kulmbach, Landkreis;Insgesamt;73926;35975;37951
09478;      Lichtenfels, Landkreis;unter 3 Jahre;1540;791;749
09478;      Lichtenfels, Landkreis;3 bis unter 6 Jahre;1600;797;803
09478;      Lichtenfels, Landkreis;6 bis unter 10 Jahre;2197;1099;1098
09478;      Lichtenfels, Landkreis;10 bis unter 15 Jahre;3368;1751;1617
09478;      Lichtenfels, Landkreis;15 bis unter 18 Jahre;2214;1145;1069
09478;      Lichtenfels, Landkreis;18 bis unter 20 Jahre;1606;851;755
09478;      Lichtenfels, Landkreis;20 bis unter 25 Jahre;3839;2019;1820
09478;      Lichtenfels, Landkreis;25 bis unter 30 Jahre;3565;1824;1741
09478;      Lichtenfels, Landkreis;30 bis unter 35 Jahre;3696;1860;1836
09478;      Lichtenfels, Landkreis;35 bis unter 40 Jahre;3907;1954;1953
09478;      Lichtenfels, Landkreis;40 bis unter 45 Jahre;5383;2666;2717
09478;      Lichtenfels, Landkreis;45 bis unter 50 Jahre;6084;3122;2962
09478;      Lichtenfels, Landkreis;50 bis unter 55 Jahre;5640;2844;2796
09478;      Lichtenfels, Landkreis;55 bis unter 60 Jahre;4896;2515;2381
09478;      Lichtenfels, Landkreis;60 bis unter 65 Jahre;4130;2108;2022
09478;      Lichtenfels, Landkreis;65 bis unter 75 Jahre;7351;3506;3845
09478;      Lichtenfels, Landkreis;75 Jahre und mehr;6936;2571;4365
09478;      Lichtenfels, Landkreis;Insgesamt;67952;33423;34529
09479;      Wunsiedel i.Fichtelgebirge, Landkreis;unter 3 Jahre;1467;739;728
09479;      Wunsiedel i.Fichtelgebirge, Landkreis;3 bis unter 6 Jahre;1530;776;754
09479;      Wunsiedel i.Fichtelgebirge, Landkreis;6 bis unter 10 Jahre;2327;1174;1153
09479;      Wunsiedel i.Fichtelgebirge, Landkreis;10 bis unter 15 Jahre;3487;1808;1679
09479;      Wunsiedel i.Fichtelgebirge, Landkreis;15 bis unter 18 Jahre;2262;1134;1128
09479;      Wunsiedel i.Fichtelgebirge, Landkreis;18 bis unter 20 Jahre;1649;843;806
09479;      Wunsiedel i.Fichtelgebirge, Landkreis;20 bis unter 25 Jahre;3847;2036;1811
09479;      Wunsiedel i.Fichtelgebirge, Landkreis;25 bis unter 30 Jahre;3642;1832;1810
09479;      Wunsiedel i.Fichtelgebirge, Landkreis;30 bis unter 35 Jahre;3535;1753;1782
09479;      Wunsiedel i.Fichtelgebirge, Landkreis;35 bis unter 40 Jahre;3713;1850;1863
09479;      Wunsiedel i.Fichtelgebirge, Landkreis;40 bis unter 45 Jahre;5705;2834;2871
09479;      Wunsiedel i.Fichtelgebirge, Landkreis;45 bis unter 50 Jahre;6288;3077;3211
09479;      Wunsiedel i.Fichtelgebirge, Landkreis;50 bis unter 55 Jahre;6334;3277;3057
09479;      Wunsiedel i.Fichtelgebirge, Landkreis;55 bis unter 60 Jahre;5464;2679;2785
09479;      Wunsiedel i.Fichtelgebirge, Landkreis;60 bis unter 65 Jahre;5223;2611;2612
09479;      Wunsiedel i.Fichtelgebirge, Landkreis;65 bis unter 75 Jahre;9657;4446;5211
09479;      Wunsiedel i.Fichtelgebirge, Landkreis;75 Jahre und mehr;9652;3499;6153
09479;      Wunsiedel i.Fichtelgebirge, Landkreis;Insgesamt;75782;36368;39414
095;    Mittelfranken, Regierungsbezirk;unter 3 Jahre;42671;22079;20592
095;    Mittelfranken, Regierungsbezirk;3 bis unter 6 Jahre;43425;22219;21206
095;    Mittelfranken, Regierungsbezirk;6 bis unter 10 Jahre;59266;30423;28843
095;    Mittelfranken, Regierungsbezirk;10 bis unter 15 Jahre;82909;42589;40320
095;    Mittelfranken, Regierungsbezirk;15 bis unter 18 Jahre;52764;27315;25449
095;    Mittelfranken, Regierungsbezirk;18 bis unter 20 Jahre;38031;19553;18478
095;    Mittelfranken, Regierungsbezirk;20 bis unter 25 Jahre;106244;53871;52373
095;    Mittelfranken, Regierungsbezirk;25 bis unter 30 Jahre;107321;54089;53232
095;    Mittelfranken, Regierungsbezirk;30 bis unter 35 Jahre;107552;54164;53388
095;    Mittelfranken, Regierungsbezirk;35 bis unter 40 Jahre;102881;51700;51181
095;    Mittelfranken, Regierungsbezirk;40 bis unter 45 Jahre;134720;68095;66625
095;    Mittelfranken, Regierungsbezirk;45 bis unter 50 Jahre;148683;75605;73078
095;    Mittelfranken, Regierungsbezirk;50 bis unter 55 Jahre;134476;67940;66536
095;    Mittelfranken, Regierungsbezirk;55 bis unter 60 Jahre;113040;56187;56853
095;    Mittelfranken, Regierungsbezirk;60 bis unter 65 Jahre;101435;49612;51823
095;    Mittelfranken, Regierungsbezirk;65 bis unter 75 Jahre;183588;86991;96597
095;    Mittelfranken, Regierungsbezirk;75 Jahre und mehr;160488;61183;99305
095;    Mittelfranken, Regierungsbezirk;Insgesamt;1719494;843615;875879
09561;      Ansbach, Stadt;unter 3 Jahre;984;516;468
09561;      Ansbach, Stadt;3 bis unter 6 Jahre;1007;493;514
09561;      Ansbach, Stadt;6 bis unter 10 Jahre;1315;671;644
09561;      Ansbach, Stadt;10 bis unter 15 Jahre;1887;956;931
09561;      Ansbach, Stadt;15 bis unter 18 Jahre;1241;641;600
09561;      Ansbach, Stadt;18 bis unter 20 Jahre;908;438;470
09561;      Ansbach, Stadt;20 bis unter 25 Jahre;2597;1285;1312
09561;      Ansbach, Stadt;25 bis unter 30 Jahre;2540;1222;1318
09561;      Ansbach, Stadt;30 bis unter 35 Jahre;2382;1201;1181
09561;      Ansbach, Stadt;35 bis unter 40 Jahre;2261;1097;1164
09561;      Ansbach, Stadt;40 bis unter 45 Jahre;2859;1426;1433
09561;      Ansbach, Stadt;45 bis unter 50 Jahre;3187;1560;1627
09561;      Ansbach, Stadt;50 bis unter 55 Jahre;3134;1533;1601
09561;      Ansbach, Stadt;55 bis unter 60 Jahre;2665;1269;1396
09561;      Ansbach, Stadt;60 bis unter 65 Jahre;2456;1198;1258
09561;      Ansbach, Stadt;65 bis unter 75 Jahre;4440;2028;2412
09561;      Ansbach, Stadt;75 Jahre und mehr;4433;1630;2803
09561;      Ansbach, Stadt;Insgesamt;40296;19164;21132
09562;      Erlangen;unter 3 Jahre;2882;1478;1404
09562;      Erlangen;3 bis unter 6 Jahre;2722;1390;1332
09562;      Erlangen;6 bis unter 10 Jahre;3597;1851;1746
09562;      Erlangen;10 bis unter 15 Jahre;4640;2359;2281
09562;      Erlangen;15 bis unter 18 Jahre;2709;1366;1343
09562;      Erlangen;18 bis unter 20 Jahre;2235;1105;1130
09562;      Erlangen;20 bis unter 25 Jahre;7956;3870;4086
09562;      Erlangen;25 bis unter 30 Jahre;9553;4933;4620
09562;      Erlangen;30 bis unter 35 Jahre;8159;4388;3771
09562;      Erlangen;35 bis unter 40 Jahre;6249;3223;3026
09562;      Erlangen;40 bis unter 45 Jahre;7493;3819;3674
09562;      Erlangen;45 bis unter 50 Jahre;8774;4404;4370
09562;      Erlangen;50 bis unter 55 Jahre;7686;3942;3744
09562;      Erlangen;55 bis unter 60 Jahre;6106;3005;3101
09562;      Erlangen;60 bis unter 65 Jahre;5420;2557;2863
09562;      Erlangen;65 bis unter 75 Jahre;10189;4708;5481
09562;      Erlangen;75 Jahre und mehr;9956;3845;6111
09562;      Erlangen;Insgesamt;106326;52243;54083
09563;      Fürth, Stadt;unter 3 Jahre;3107;1631;1476
09563;      Fürth, Stadt;3 bis unter 6 Jahre;3006;1534;1472
09563;      Fürth, Stadt;6 bis unter 10 Jahre;4012;2079;1933
09563;      Fürth, Stadt;10 bis unter 15 Jahre;5333;2774;2559
09563;      Fürth, Stadt;15 bis unter 18 Jahre;3522;1826;1696
09563;      Fürth, Stadt;18 bis unter 20 Jahre;2477;1275;1202
09563;      Fürth, Stadt;20 bis unter 25 Jahre;7265;3619;3646
09563;      Fürth, Stadt;25 bis unter 30 Jahre;7892;3895;3997
09563;      Fürth, Stadt;30 bis unter 35 Jahre;8115;3979;4136
09563;      Fürth, Stadt;35 bis unter 40 Jahre;7363;3694;3669
09563;      Fürth, Stadt;40 bis unter 45 Jahre;9225;4689;4536
09563;      Fürth, Stadt;45 bis unter 50 Jahre;10216;5132;5084
09563;      Fürth, Stadt;50 bis unter 55 Jahre;8992;4497;4495
09563;      Fürth, Stadt;55 bis unter 60 Jahre;7463;3610;3853
09563;      Fürth, Stadt;60 bis unter 65 Jahre;6550;3148;3402
09563;      Fürth, Stadt;65 bis unter 75 Jahre;11937;5551;6386
09563;      Fürth, Stadt;75 Jahre und mehr;9842;3650;6192
09563;      Fürth, Stadt;Insgesamt;116317;56583;59734
09564;      Nürnberg;unter 3 Jahre;13268;6767;6501
09564;      Nürnberg;3 bis unter 6 Jahre;12612;6469;6143
09564;      Nürnberg;6 bis unter 10 Jahre;16030;8187;7843
09564;      Nürnberg;10 bis unter 15 Jahre;20478;10514;9964
09564;      Nürnberg;15 bis unter 18 Jahre;12426;6463;5963
09564;      Nürnberg;18 bis unter 20 Jahre;10021;5098;4923
09564;      Nürnberg;20 bis unter 25 Jahre;34046;16419;17627
09564;      Nürnberg;25 bis unter 30 Jahre;37967;18810;19157
09564;      Nürnberg;30 bis unter 35 Jahre;37909;19146;18763
09564;      Nürnberg;35 bis unter 40 Jahre;33257;16865;16392
09564;      Nürnberg;40 bis unter 45 Jahre;39406;20512;18894
09564;      Nürnberg;45 bis unter 50 Jahre;40954;21284;19670
09564;      Nürnberg;50 bis unter 55 Jahre;36430;18304;18126
09564;      Nürnberg;55 bis unter 60 Jahre;31425;15211;16214
09564;      Nürnberg;60 bis unter 65 Jahre;29463;13923;15540
09564;      Nürnberg;65 bis unter 75 Jahre;55851;25875;29976
09564;      Nürnberg;75 Jahre und mehr;49059;18092;30967
09564;      Nürnberg;Insgesamt;510602;247939;262663
09565;      Schwabach;unter 3 Jahre;907;467;440
09565;      Schwabach;3 bis unter 6 Jahre;1049;522;527
09565;      Schwabach;6 bis unter 10 Jahre;1357;669;688
09565;      Schwabach;10 bis unter 15 Jahre;2023;1061;962
09565;      Schwabach;15 bis unter 18 Jahre;1254;659;595
09565;      Schwabach;18 bis unter 20 Jahre;871;422;449
09565;      Schwabach;20 bis unter 25 Jahre;2178;1086;1092
09565;      Schwabach;25 bis unter 30 Jahre;2106;1090;1016
09565;      Schwabach;30 bis unter 35 Jahre;2231;1090;1141
09565;      Schwabach;35 bis unter 40 Jahre;2259;1061;1198
09565;      Schwabach;40 bis unter 45 Jahre;3229;1597;1632
09565;      Schwabach;45 bis unter 50 Jahre;3594;1833;1761
09565;      Schwabach;50 bis unter 55 Jahre;2970;1487;1483
09565;      Schwabach;55 bis unter 60 Jahre;2454;1194;1260
09565;      Schwabach;60 bis unter 65 Jahre;2379;1088;1291
09565;      Schwabach;65 bis unter 75 Jahre;4559;2160;2399
09565;      Schwabach;75 Jahre und mehr;3692;1357;2335
09565;      Schwabach;Insgesamt;39112;18843;20269
09571;      Ansbach, Landkreis;unter 3 Jahre;4332;2200;2132
09571;      Ansbach, Landkreis;3 bis unter 6 Jahre;4648;2372;2276
09571;      Ansbach, Landkreis;6 bis unter 10 Jahre;6743;3518;3225
09571;      Ansbach, Landkreis;10 bis unter 15 Jahre;10075;5182;4893
09571;      Ansbach, Landkreis;15 bis unter 18 Jahre;6750;3524;3226
09571;      Ansbach, Landkreis;18 bis unter 20 Jahre;4601;2398;2203
09571;      Ansbach, Landkreis;20 bis unter 25 Jahre;11094;5924;5170
09571;      Ansbach, Landkreis;25 bis unter 30 Jahre;9817;5061;4756
09571;      Ansbach, Landkreis;30 bis unter 35 Jahre;9958;5051;4907
09571;      Ansbach, Landkreis;35 bis unter 40 Jahre;10347;5187;5160
09571;      Ansbach, Landkreis;40 bis unter 45 Jahre;14081;7079;7002
09571;      Ansbach, Landkreis;45 bis unter 50 Jahre;15745;8048;7697
09571;      Ansbach, Landkreis;50 bis unter 55 Jahre;14829;7529;7300
09571;      Ansbach, Landkreis;55 bis unter 60 Jahre;12296;6334;5962
09571;      Ansbach, Landkreis;60 bis unter 65 Jahre;10307;5215;5092
09571;      Ansbach, Landkreis;65 bis unter 75 Jahre;17079;8270;8809
09571;      Ansbach, Landkreis;75 Jahre und mehr;16855;6500;10355
09571;      Ansbach, Landkreis;Insgesamt;179557;89392;90165
09572;      Erlangen-Höchstadt, Landkreis;unter 3 Jahre;3345;1762;1583
09572;      Erlangen-Höchstadt, Landkreis;3 bis unter 6 Jahre;3630;1865;1765
09572;      Erlangen-Höchstadt, Landkreis;6 bis unter 10 Jahre;4997;2536;2461
09572;      Erlangen-Höchstadt, Landkreis;10 bis unter 15 Jahre;7188;3704;3484
09572;      Erlangen-Höchstadt, Landkreis;15 bis unter 18 Jahre;4490;2331;2159
09572;      Erlangen-Höchstadt, Landkreis;18 bis unter 20 Jahre;2976;1546;1430
09572;      Erlangen-Höchstadt, Landkreis;20 bis unter 25 Jahre;7520;3873;3647
09572;      Erlangen-Höchstadt, Landkreis;25 bis unter 30 Jahre;7030;3652;3378
09572;      Erlangen-Höchstadt, Landkreis;30 bis unter 35 Jahre;7424;3688;3736
09572;      Erlangen-Höchstadt, Landkreis;35 bis unter 40 Jahre;7654;3827;3827
09572;      Erlangen-Höchstadt, Landkreis;40 bis unter 45 Jahre;10623;5219;5404
09572;      Erlangen-Höchstadt, Landkreis;45 bis unter 50 Jahre;11913;6009;5904
09572;      Erlangen-Höchstadt, Landkreis;50 bis unter 55 Jahre;11159;5614;5545
09572;      Erlangen-Höchstadt, Landkreis;55 bis unter 60 Jahre;9538;4808;4730
09572;      Erlangen-Höchstadt, Landkreis;60 bis unter 65 Jahre;8158;4160;3998
09572;      Erlangen-Höchstadt, Landkreis;65 bis unter 75 Jahre;13796;6768;7028
09572;      Erlangen-Höchstadt, Landkreis;75 Jahre und mehr;10608;4373;6235
09572;      Erlangen-Höchstadt, Landkreis;Insgesamt;132049;65735;66314
09573;      Fürth, Landkreis;unter 3 Jahre;2740;1418;1322
09573;      Fürth, Landkreis;3 bis unter 6 Jahre;2850;1437;1413
09573;      Fürth, Landkreis;6 bis unter 10 Jahre;3825;1940;1885
09573;      Fürth, Landkreis;10 bis unter 15 Jahre;5700;2918;2782
09573;      Fürth, Landkreis;15 bis unter 18 Jahre;3656;1895;1761
09573;      Fürth, Landkreis;18 bis unter 20 Jahre;2562;1366;1196
09573;      Fürth, Landkreis;20 bis unter 25 Jahre;6022;3184;2838
09573;      Fürth, Landkreis;25 bis unter 30 Jahre;5813;2898;2915
09573;      Fürth, Landkreis;30 bis unter 35 Jahre;6135;3081;3054
09573;      Fürth, Landkreis;35 bis unter 40 Jahre;6679;3414;3265
09573;      Fürth, Landkreis;40 bis unter 45 Jahre;9467;4586;4881
09573;      Fürth, Landkreis;45 bis unter 50 Jahre;10857;5269;5588
09573;      Fürth, Landkreis;50 bis unter 55 Jahre;9782;4938;4844
09573;      Fürth, Landkreis;55 bis unter 60 Jahre;8113;4156;3957
09573;      Fürth, Landkreis;60 bis unter 65 Jahre;7379;3607;3772
09573;      Fürth, Landkreis;65 bis unter 75 Jahre;13507;6499;7008
09573;      Fürth, Landkreis;75 Jahre und mehr;10541;4195;6346
09573;      Fürth, Landkreis;Insgesamt;115628;56801;58827
09574;      Nürnberger Land, Landkreis;unter 3 Jahre;3773;2007;1766
09574;      Nürnberger Land, Landkreis;3 bis unter 6 Jahre;4067;2118;1949
09574;      Nürnberger Land, Landkreis;6 bis unter 10 Jahre;5778;3009;2769
09574;      Nürnberger Land, Landkreis;10 bis unter 15 Jahre;8266;4234;4032
09574;      Nürnberger Land, Landkreis;15 bis unter 18 Jahre;5462;2821;2641
09574;      Nürnberger Land, Landkreis;18 bis unter 20 Jahre;3709;1930;1779
09574;      Nürnberger Land, Landkreis;20 bis unter 25 Jahre;8846;4653;4193
09574;      Nürnberger Land, Landkreis;25 bis unter 30 Jahre;8111;4019;4092
09574;      Nürnberger Land, Landkreis;30 bis unter 35 Jahre;8632;4207;4425
09574;      Nürnberger Land, Landkreis;35 bis unter 40 Jahre;9433;4645;4788
09574;      Nürnberger Land, Landkreis;40 bis unter 45 Jahre;13873;6923;6950
09574;      Nürnberger Land, Landkreis;45 bis unter 50 Jahre;15104;7659;7445
09574;      Nürnberger Land, Landkreis;50 bis unter 55 Jahre;13715;6965;6750
09574;      Nürnberger Land, Landkreis;55 bis unter 60 Jahre;11332;5545;5787
09574;      Nürnberger Land, Landkreis;60 bis unter 65 Jahre;10405;5119;5286
09574;      Nürnberger Land, Landkreis;65 bis unter 75 Jahre;19519;9395;10124
09574;      Nürnberger Land, Landkreis;75 Jahre und mehr;16184;6276;9908
09574;      Nürnberger Land, Landkreis;Insgesamt;166209;81525;84684
09575;      Neustadt a.d.Aisch-Bad Windsheim, Landkreis;unter 3 Jahre;2222;1137;1085
09575;      Neustadt a.d.Aisch-Bad Windsheim, Landkreis;3 bis unter 6 Jahre;2453;1262;1191
09575;      Neustadt a.d.Aisch-Bad Windsheim, Landkreis;6 bis unter 10 Jahre;3654;1917;1737
09575;      Neustadt a.d.Aisch-Bad Windsheim, Landkreis;10 bis unter 15 Jahre;5443;2794;2649
09575;      Neustadt a.d.Aisch-Bad Windsheim, Landkreis;15 bis unter 18 Jahre;3477;1758;1719
09575;      Neustadt a.d.Aisch-Bad Windsheim, Landkreis;18 bis unter 20 Jahre;2466;1282;1184
09575;      Neustadt a.d.Aisch-Bad Windsheim, Landkreis;20 bis unter 25 Jahre;5936;3181;2755
09575;      Neustadt a.d.Aisch-Bad Windsheim, Landkreis;25 bis unter 30 Jahre;5237;2728;2509
09575;      Neustadt a.d.Aisch-Bad Windsheim, Landkreis;30 bis unter 35 Jahre;5181;2591;2590
09575;      Neustadt a.d.Aisch-Bad Windsheim, Landkreis;35 bis unter 40 Jahre;5352;2679;2673
09575;      Neustadt a.d.Aisch-Bad Windsheim, Landkreis;40 bis unter 45 Jahre;7501;3705;3796
09575;      Neustadt a.d.Aisch-Bad Windsheim, Landkreis;45 bis unter 50 Jahre;8777;4492;4285
09575;      Neustadt a.d.Aisch-Bad Windsheim, Landkreis;50 bis unter 55 Jahre;8072;4111;3961
09575;      Neustadt a.d.Aisch-Bad Windsheim, Landkreis;55 bis unter 60 Jahre;6777;3479;3298
09575;      Neustadt a.d.Aisch-Bad Windsheim, Landkreis;60 bis unter 65 Jahre;5899;3097;2802
09575;      Neustadt a.d.Aisch-Bad Windsheim, Landkreis;65 bis unter 75 Jahre;9674;4686;4988
09575;      Neustadt a.d.Aisch-Bad Windsheim, Landkreis;75 Jahre und mehr;9360;3496;5864
09575;      Neustadt a.d.Aisch-Bad Windsheim, Landkreis;Insgesamt;97481;48395;49086
09576;      Roth, Landkreis;unter 3 Jahre;2982;1559;1423
09576;      Roth, Landkreis;3 bis unter 6 Jahre;3116;1605;1511
09576;      Roth, Landkreis;6 bis unter 10 Jahre;4459;2289;2170
09576;      Roth, Landkreis;10 bis unter 15 Jahre;6861;3470;3391
09576;      Roth, Landkreis;15 bis unter 18 Jahre;4467;2337;2130
09576;      Roth, Landkreis;18 bis unter 20 Jahre;3015;1562;1453
09576;      Roth, Landkreis;20 bis unter 25 Jahre;7143;3740;3403
09576;      Roth, Landkreis;25 bis unter 30 Jahre;6446;3299;3147
09576;      Roth, Landkreis;30 bis unter 35 Jahre;6583;3262;3321
09576;      Roth, Landkreis;35 bis unter 40 Jahre;6968;3414;3554
09576;      Roth, Landkreis;40 bis unter 45 Jahre;10270;5144;5126
09576;      Roth, Landkreis;45 bis unter 50 Jahre;11550;5800;5750
09576;      Roth, Landkreis;50 bis unter 55 Jahre;10186;5259;4927
09576;      Roth, Landkreis;55 bis unter 60 Jahre;8483;4260;4223
09576;      Roth, Landkreis;60 bis unter 65 Jahre;7316;3647;3669
09576;      Roth, Landkreis;65 bis unter 75 Jahre;13348;6429;6919
09576;      Roth, Landkreis;75 Jahre und mehr;10789;4313;6476
09576;      Roth, Landkreis;Insgesamt;123982;61389;62593
09577;      Weißenburg-Gunzenhausen, Landkreis;unter 3 Jahre;2129;1137;992
09577;      Weißenburg-Gunzenhausen, Landkreis;3 bis unter 6 Jahre;2265;1152;1113
09577;      Weißenburg-Gunzenhausen, Landkreis;6 bis unter 10 Jahre;3499;1757;1742
09577;      Weißenburg-Gunzenhausen, Landkreis;10 bis unter 15 Jahre;5015;2623;2392
09577;      Weißenburg-Gunzenhausen, Landkreis;15 bis unter 18 Jahre;3310;1694;1616
09577;      Weißenburg-Gunzenhausen, Landkreis;18 bis unter 20 Jahre;2190;1131;1059
09577;      Weißenburg-Gunzenhausen, Landkreis;20 bis unter 25 Jahre;5641;3037;2604
09577;      Weißenburg-Gunzenhausen, Landkreis;25 bis unter 30 Jahre;4809;2482;2327
09577;      Weißenburg-Gunzenhausen, Landkreis;30 bis unter 35 Jahre;4843;2480;2363
09577;      Weißenburg-Gunzenhausen, Landkreis;35 bis unter 40 Jahre;5059;2594;2465
09577;      Weißenburg-Gunzenhausen, Landkreis;40 bis unter 45 Jahre;6693;3396;3297
09577;      Weißenburg-Gunzenhausen, Landkreis;45 bis unter 50 Jahre;8012;4115;3897
09577;      Weißenburg-Gunzenhausen, Landkreis;50 bis unter 55 Jahre;7521;3761;3760
09577;      Weißenburg-Gunzenhausen, Landkreis;55 bis unter 60 Jahre;6388;3316;3072
09577;      Weißenburg-Gunzenhausen, Landkreis;60 bis unter 65 Jahre;5703;2853;2850
09577;      Weißenburg-Gunzenhausen, Landkreis;65 bis unter 75 Jahre;9689;4622;5067
09577;      Weißenburg-Gunzenhausen, Landkreis;75 Jahre und mehr;9169;3456;5713
09577;      Weißenburg-Gunzenhausen, Landkreis;Insgesamt;91935;45606;46329
096;    Unterfranken, Regierungsbezirk;unter 3 Jahre;30068;15325;14743
096;    Unterfranken, Regierungsbezirk;3 bis unter 6 Jahre;31172;15988;15184
096;    Unterfranken, Regierungsbezirk;6 bis unter 10 Jahre;45199;23061;22138
096;    Unterfranken, Regierungsbezirk;10 bis unter 15 Jahre;65420;33436;31984
096;    Unterfranken, Regierungsbezirk;15 bis unter 18 Jahre;42987;22287;20700
096;    Unterfranken, Regierungsbezirk;18 bis unter 20 Jahre;31356;16173;15183
096;    Unterfranken, Regierungsbezirk;20 bis unter 25 Jahre;84210;42790;41420
096;    Unterfranken, Regierungsbezirk;25 bis unter 30 Jahre;79248;40660;38588
096;    Unterfranken, Regierungsbezirk;30 bis unter 35 Jahre;74266;37773;36493
096;    Unterfranken, Regierungsbezirk;35 bis unter 40 Jahre;73661;36636;37025
096;    Unterfranken, Regierungsbezirk;40 bis unter 45 Jahre;99419;49783;49636
096;    Unterfranken, Regierungsbezirk;45 bis unter 50 Jahre;116837;59205;57632
096;    Unterfranken, Regierungsbezirk;50 bis unter 55 Jahre;107212;54141;53071
096;    Unterfranken, Regierungsbezirk;55 bis unter 60 Jahre;91618;46054;45564
096;    Unterfranken, Regierungsbezirk;60 bis unter 65 Jahre;79646;40118;39528
096;    Unterfranken, Regierungsbezirk;65 bis unter 75 Jahre;134711;64603;70108
096;    Unterfranken, Regierungsbezirk;75 Jahre und mehr;127880;49730;78150
096;    Unterfranken, Regierungsbezirk;Insgesamt;1314910;647763;667147
09661;      Aschaffenburg, Stadt;unter 3 Jahre;1747;919;828
09661;      Aschaffenburg, Stadt;3 bis unter 6 Jahre;1789;915;874
09661;      Aschaffenburg, Stadt;6 bis unter 10 Jahre;2333;1189;1144
09661;      Aschaffenburg, Stadt;10 bis unter 15 Jahre;3144;1572;1572
09661;      Aschaffenburg, Stadt;15 bis unter 18 Jahre;1941;1003;938
09661;      Aschaffenburg, Stadt;18 bis unter 20 Jahre;1356;675;681
09661;      Aschaffenburg, Stadt;20 bis unter 25 Jahre;4103;2060;2043
09661;      Aschaffenburg, Stadt;25 bis unter 30 Jahre;4663;2292;2371
09661;      Aschaffenburg, Stadt;30 bis unter 35 Jahre;4645;2307;2338
09661;      Aschaffenburg, Stadt;35 bis unter 40 Jahre;4279;2136;2143
09661;      Aschaffenburg, Stadt;40 bis unter 45 Jahre;5173;2582;2591
09661;      Aschaffenburg, Stadt;45 bis unter 50 Jahre;5777;2845;2932
09661;      Aschaffenburg, Stadt;50 bis unter 55 Jahre;5230;2627;2603
09661;      Aschaffenburg, Stadt;55 bis unter 60 Jahre;4622;2198;2424
09661;      Aschaffenburg, Stadt;60 bis unter 65 Jahre;4165;2027;2138
09661;      Aschaffenburg, Stadt;65 bis unter 75 Jahre;7076;3278;3798
09661;      Aschaffenburg, Stadt;75 Jahre und mehr;6765;2479;4286
09661;      Aschaffenburg, Stadt;Insgesamt;68808;33104;35704
09662;      Schweinfurt, Stadt;unter 3 Jahre;1243;600;643
09662;      Schweinfurt, Stadt;;3 bis unter 6 Jahre;1263;655;608
09662;      Schweinfurt, Stadt;;6 bis unter 10 Jahre;1664;860;804
09662;      Schweinfurt, Stadt;;10 bis unter 15 Jahre;2211;1123;1088
09662;      Schweinfurt, Stadt;;15 bis unter 18 Jahre;1424;724;700
09662;      Schweinfurt, Stadt;;18 bis unter 20 Jahre;1168;595;573
09662;      Schweinfurt, Stadt;;20 bis unter 25 Jahre;3685;1890;1795
09662;      Schweinfurt, Stadt;;25 bis unter 30 Jahre;3450;1761;1689
09662;      Schweinfurt, Stadt;;30 bis unter 35 Jahre;3183;1635;1548
09662;      Schweinfurt, Stadt;;35 bis unter 40 Jahre;2767;1434;1333
09662;      Schweinfurt, Stadt;;40 bis unter 45 Jahre;3464;1742;1722
09662;      Schweinfurt, Stadt;;45 bis unter 50 Jahre;4047;2107;1940
09662;      Schweinfurt, Stadt;;50 bis unter 55 Jahre;3970;1977;1993
09662;      Schweinfurt, Stadt;;55 bis unter 60 Jahre;3605;1724;1881
09662;      Schweinfurt, Stadt;;60 bis unter 65 Jahre;3245;1561;1684
09662;      Schweinfurt, Stadt;;65 bis unter 75 Jahre;6296;2863;3433
09662;      Schweinfurt, Stadt;;75 Jahre und mehr;6562;2415;4147
09662;      Schweinfurt, Stadt;;Insgesamt;53247;25666;27581
09663;      Würzburg, Stadt;unter 3 Jahre;2786;1406;1380
09663;      Würzburg, Stadt;3 bis unter 6 Jahre;2561;1328;1233
09663;      Würzburg, Stadt;6 bis unter 10 Jahre;3268;1663;1605
09663;      Würzburg, Stadt;10 bis unter 15 Jahre;4362;2241;2121
09663;      Würzburg, Stadt;15 bis unter 18 Jahre;2671;1328;1343
09663;      Würzburg, Stadt;18 bis unter 20 Jahre;2790;1281;1509
09663;      Würzburg, Stadt;20 bis unter 25 Jahre;14508;6064;8444
09663;      Würzburg, Stadt;25 bis unter 30 Jahre;13948;6929;7019
09663;      Würzburg, Stadt;30 bis unter 35 Jahre;10224;5347;4877
09663;      Würzburg, Stadt;35 bis unter 40 Jahre;7532;3913;3619
09663;      Würzburg, Stadt;40 bis unter 45 Jahre;8350;4158;4192
09663;      Würzburg, Stadt;45 bis unter 50 Jahre;11958;5667;6291
09663;      Würzburg, Stadt;50 bis unter 55 Jahre;9457;4650;4807
09663;      Würzburg, Stadt;55 bis unter 60 Jahre;7273;3449;3824
09663;      Würzburg, Stadt;60 bis unter 65 Jahre;6585;3000;3585
09663;      Würzburg, Stadt;65 bis unter 75 Jahre;12534;5579;6955
09663;      Würzburg, Stadt;75 Jahre und mehr;13001;4510;8491
09663;      Würzburg, Stadt;Insgesamt;133808;62513;71295
09671;      Aschaffenburg, Landkreis;unter 3 Jahre;3881;2013;1868
09671;      Aschaffenburg, Landkreis;3 bis unter 6 Jahre;4266;2133;2133
09671;      Aschaffenburg, Landkreis;6 bis unter 10 Jahre;6160;3131;3029
09671;      Aschaffenburg, Landkreis;10 bis unter 15 Jahre;9046;4658;4388
09671;      Aschaffenburg, Landkreis;15 bis unter 18 Jahre;5984;3114;2870
09671;      Aschaffenburg, Landkreis;18 bis unter 20 Jahre;4194;2156;2038
09671;      Aschaffenburg, Landkreis;20 bis unter 25 Jahre;9820;5167;4653
09671;      Aschaffenburg, Landkreis;25 bis unter 30 Jahre;9054;4693;4361
09671;      Aschaffenburg, Landkreis;30 bis unter 35 Jahre;9085;4590;4495
09671;      Aschaffenburg, Landkreis;35 bis unter 40 Jahre;9555;4592;4963
09671;      Aschaffenburg, Landkreis;40 bis unter 45 Jahre;13971;6907;7064
09671;      Aschaffenburg, Landkreis;45 bis unter 50 Jahre;16218;8158;8060
09671;      Aschaffenburg, Landkreis;50 bis unter 55 Jahre;14392;7352;7040
09671;      Aschaffenburg, Landkreis;55 bis unter 60 Jahre;12165;6164;6001
09671;      Aschaffenburg, Landkreis;60 bis unter 65 Jahre;10604;5374;5230
09671;      Aschaffenburg, Landkreis;65 bis unter 75 Jahre;17819;8681;9138
09671;      Aschaffenburg, Landkreis;75 Jahre und mehr;15948;6484;9464
09671;      Aschaffenburg, Landkreis;Insgesamt;172162;85367;86795
09672;      Bad Kissingen, Landkreis;unter 3 Jahre;2307;1175;1132
09672;      Bad Kissingen, Landkreis;3 bis unter 6 Jahre;2344;1179;1165
09672;      Bad Kissingen, Landkreis;6 bis unter 10 Jahre;3626;1815;1811
09672;      Bad Kissingen, Landkreis;10 bis unter 15 Jahre;5123;2521;2602
09672;      Bad Kissingen, Landkreis;15 bis unter 18 Jahre;3542;1821;1721
09672;      Bad Kissingen, Landkreis;18 bis unter 20 Jahre;2464;1269;1195
09672;      Bad Kissingen, Landkreis;20 bis unter 25 Jahre;5769;3105;2664
09672;      Bad Kissingen, Landkreis;25 bis unter 30 Jahre;5426;2881;2545
09672;      Bad Kissingen, Landkreis;30 bis unter 35 Jahre;5076;2605;2471
09672;      Bad Kissingen, Landkreis;35 bis unter 40 Jahre;5496;2661;2835
09672;      Bad Kissingen, Landkreis;40 bis unter 45 Jahre;7567;3779;3788
09672;      Bad Kissingen, Landkreis;45 bis unter 50 Jahre;8749;4500;4249
09672;      Bad Kissingen, Landkreis;50 bis unter 55 Jahre;8605;4350;4255
09672;      Bad Kissingen, Landkreis;55 bis unter 60 Jahre;7590;3841;3749
09672;      Bad Kissingen, Landkreis;60 bis unter 65 Jahre;6707;3388;3319
09672;      Bad Kissingen, Landkreis;65 bis unter 75 Jahre;11524;5429;6095
09672;      Bad Kissingen, Landkreis;75 Jahre und mehr;11842;4385;7457
09672;      Bad Kissingen, Landkreis;Insgesamt;103757;50704;53053
09673;      Rhön-Grabfeld, Landkreis;unter 3 Jahre;1823;949;874
09673;      Rhön-Grabfeld, Landkreis;3 bis unter 6 Jahre;2018;1010;1008
09673;      Rhön-Grabfeld, Landkreis;6 bis unter 10 Jahre;2949;1467;1482
09673;      Rhön-Grabfeld, Landkreis;10 bis unter 15 Jahre;4402;2283;2119
09673;      Rhön-Grabfeld, Landkreis;15 bis unter 18 Jahre;2944;1510;1434
09673;      Rhön-Grabfeld, Landkreis;18 bis unter 20 Jahre;2067;1055;1012
09673;      Rhön-Grabfeld, Landkreis;20 bis unter 25 Jahre;4840;2612;2228
09673;      Rhön-Grabfeld, Landkreis;25 bis unter 30 Jahre;4346;2287;2059
09673;      Rhön-Grabfeld, Landkreis;30 bis unter 35 Jahre;4307;2167;2140
09673;      Rhön-Grabfeld, Landkreis;35 bis unter 40 Jahre;4603;2341;2262
09673;      Rhön-Grabfeld, Landkreis;40 bis unter 45 Jahre;6413;3265;3148
09673;      Rhön-Grabfeld, Landkreis;45 bis unter 50 Jahre;7215;3761;3454
09673;      Rhön-Grabfeld, Landkreis;50 bis unter 55 Jahre;6743;3418;3325
09673;      Rhön-Grabfeld, Landkreis;55 bis unter 60 Jahre;6034;3117;2917
09673;      Rhön-Grabfeld, Landkreis;60 bis unter 65 Jahre;5105;2689;2416
09673;      Rhön-Grabfeld, Landkreis;65 bis unter 75 Jahre;8302;4065;4237
09673;      Rhön-Grabfeld, Landkreis;75 Jahre und mehr;8213;3319;4894
09673;      Rhön-Grabfeld, Landkreis;Insgesamt;82324;41315;41009
09674;      Haßberge, Landkreis;unter 3 Jahre;1990;978;1012
09674;      Haßberge, Landkreis;3 bis unter 6 Jahre;2015;1065;950
09674;      Haßberge, Landkreis;6 bis unter 10 Jahre;3076;1611;1465
09674;      Haßberge, Landkreis;10 bis unter 15 Jahre;4668;2355;2313
09674;      Haßberge, Landkreis;15 bis unter 18 Jahre;3008;1557;1451
09674;      Haßberge, Landkreis;18 bis unter 20 Jahre;2121;1129;992
09674;      Haßberge, Landkreis;20 bis unter 25 Jahre;5118;2706;2412
09674;      Haßberge, Landkreis;25 bis unter 30 Jahre;4864;2505;2359
09674;      Haßberge, Landkreis;30 bis unter 35 Jahre;4445;2336;2109
09674;      Haßberge, Landkreis;35 bis unter 40 Jahre;4724;2402;2322
09674;      Haßberge, Landkreis;40 bis unter 45 Jahre;6464;3278;3186
09674;      Haßberge, Landkreis;45 bis unter 50 Jahre;7525;3857;3668
09674;      Haßberge, Landkreis;50 bis unter 55 Jahre;7511;3825;3686
09674;      Haßberge, Landkreis;55 bis unter 60 Jahre;6210;3222;2988
09674;      Haßberge, Landkreis;60 bis unter 65 Jahre;5193;2733;2460
09674;      Haßberge, Landkreis;65 bis unter 75 Jahre;8151;3937;4214
09674;      Haßberge, Landkreis;75 Jahre und mehr;7654;2937;4717
09674;      Haßberge, Landkreis;Insgesamt;84737;42433;42304
09675;      Kitzingen, Landkreis;unter 3 Jahre;1967;997;970
09675;      Kitzingen, Landkreis;3 bis unter 6 Jahre;2157;1080;1077
09675;      Kitzingen, Landkreis;6 bis unter 10 Jahre;3191;1607;1584
09675;      Kitzingen, Landkreis;10 bis unter 15 Jahre;4592;2370;2222
09675;      Kitzingen, Landkreis;15 bis unter 18 Jahre;3154;1671;1483
09675;      Kitzingen, Landkreis;18 bis unter 20 Jahre;2190;1160;1030
09675;      Kitzingen, Landkreis;20 bis unter 25 Jahre;5492;2878;2614
09675;      Kitzingen, Landkreis;25 bis unter 30 Jahre;4969;2527;2442
09675;      Kitzingen, Landkreis;30 bis unter 35 Jahre;4988;2514;2474
09675;      Kitzingen, Landkreis;35 bis unter 40 Jahre;5079;2515;2564
09675;      Kitzingen, Landkreis;40 bis unter 45 Jahre;7251;3758;3493
09675;      Kitzingen, Landkreis;45 bis unter 50 Jahre;7982;4150;3832
09675;      Kitzingen, Landkreis;50 bis unter 55 Jahre;7138;3628;3510
09675;      Kitzingen, Landkreis;55 bis unter 60 Jahre;5999;3110;2889
09675;      Kitzingen, Landkreis;60 bis unter 65 Jahre;5325;2751;2574
09675;      Kitzingen, Landkreis;65 bis unter 75 Jahre;8601;4173;4428
09675;      Kitzingen, Landkreis;75 Jahre und mehr;8331;3244;5087
09675;      Kitzingen, Landkreis;Insgesamt;88406;44133;44273
09676;      Miltenberg, Landkreis;unter 3 Jahre;3061;1553;1508
09676;      Miltenberg, Landkreis;3 bis unter 6 Jahre;3253;1731;1522
09676;      Miltenberg, Landkreis;6 bis unter 10 Jahre;4747;2441;2306
09676;      Miltenberg, Landkreis;10 bis unter 15 Jahre;7102;3642;3460
09676;      Miltenberg, Landkreis;15 bis unter 18 Jahre;4616;2457;2159
09676;      Miltenberg, Landkreis;18 bis unter 20 Jahre;3236;1746;1490
09676;      Miltenberg, Landkreis;20 bis unter 25 Jahre;7372;3944;3428
09676;      Miltenberg, Landkreis;25 bis unter 30 Jahre;6874;3532;3342
09676;      Miltenberg, Landkreis;30 bis unter 35 Jahre;6842;3406;3436
09676;      Miltenberg, Landkreis;35 bis unter 40 Jahre;7515;3638;3877
09676;      Miltenberg, Landkreis;40 bis unter 45 Jahre;10136;5121;5015
09676;      Miltenberg, Landkreis;45 bis unter 50 Jahre;11356;5923;5433
09676;      Miltenberg, Landkreis;50 bis unter 55 Jahre;10220;5110;5110
09676;      Miltenberg, Landkreis;55 bis unter 60 Jahre;8930;4500;4430
09676;      Miltenberg, Landkreis;60 bis unter 65 Jahre;7587;3850;3737
09676;      Miltenberg, Landkreis;65 bis unter 75 Jahre;13147;6459;6688
09676;      Miltenberg, Landkreis;75 Jahre und mehr;11829;4734;7095
09676;      Miltenberg, Landkreis;Insgesamt;127823;63787;64036
09677;      Main-Spessart, Landkreis;unter 3 Jahre;2769;1382;1387
09677;      Main-Spessart, Landkreis;3 bis unter 6 Jahre;2900;1502;1398
09677;      Main-Spessart, Landkreis;6 bis unter 10 Jahre;4440;2254;2186
09677;      Main-Spessart, Landkreis;10 bis unter 15 Jahre;6513;3335;3178
09677;      Main-Spessart, Landkreis;15 bis unter 18 Jahre;4361;2266;2095
09677;      Main-Spessart, Landkreis;18 bis unter 20 Jahre;3111;1595;1516
09677;      Main-Spessart, Landkreis;20 bis unter 25 Jahre;7383;3949;3434
09677;      Main-Spessart, Landkreis;25 bis unter 30 Jahre;6631;3501;3130
09677;      Main-Spessart, Landkreis;30 bis unter 35 Jahre;6666;3436;3230
09677;      Main-Spessart, Landkreis;35 bis unter 40 Jahre;7028;3520;3508
09677;      Main-Spessart, Landkreis;40 bis unter 45 Jahre;9821;4932;4889
09677;      Main-Spessart, Landkreis;45 bis unter 50 Jahre;11380;5756;5624
09677;      Main-Spessart, Landkreis;50 bis unter 55 Jahre;10726;5530;5196
09677;      Main-Spessart, Landkreis;55 bis unter 60 Jahre;9317;4728;4589
09677;      Main-Spessart, Landkreis;60 bis unter 65 Jahre;8057;4187;3870
09677;      Main-Spessart, Landkreis;65 bis unter 75 Jahre;13296;6470;6826
09677;      Main-Spessart, Landkreis;75 Jahre und mehr;12815;4994;7821
09677;      Main-Spessart, Landkreis;Insgesamt;127214;63337;63877
09678;      Schweinfurt, Landkreis;unter 3 Jahre;2536;1332;1204
09678;      Schweinfurt, Landkreis;3 bis unter 6 Jahre;2579;1347;1232
09678;      Schweinfurt, Landkreis;6 bis unter 10 Jahre;3962;2054;1908
09678;      Schweinfurt, Landkreis;10 bis unter 15 Jahre;6010;3035;2975
09678;      Schweinfurt, Landkreis;15 bis unter 18 Jahre;4049;2140;1909
09678;      Schweinfurt, Landkreis;18 bis unter 20 Jahre;2878;1511;1367
09678;      Schweinfurt, Landkreis;20 bis unter 25 Jahre;6710;3626;3084
09678;      Schweinfurt, Landkreis;25 bis unter 30 Jahre;6003;3118;2885
09678;      Schweinfurt, Landkreis;30 bis unter 35 Jahre;5899;2968;2931
09678;      Schweinfurt, Landkreis;35 bis unter 40 Jahre;5942;2927;3015
09678;      Schweinfurt, Landkreis;40 bis unter 45 Jahre;8474;4191;4283
09678;      Schweinfurt, Landkreis;45 bis unter 50 Jahre;10262;5318;4944
09678;      Schweinfurt, Landkreis;50 bis unter 55 Jahre;9437;4791;4646
09678;      Schweinfurt, Landkreis;55 bis unter 60 Jahre;8358;4263;4095
09678;      Schweinfurt, Landkreis;60 bis unter 65 Jahre;6848;3453;3395
09678;      Schweinfurt, Landkreis;65 bis unter 75 Jahre;11954;5788;6166
09678;      Schweinfurt, Landkreis;75 Jahre und mehr;10921;4388;6533
09678;      Schweinfurt, Landkreis;Insgesamt;112822;56250;56572
09679;      Würzburg, Landkreis;unter 3 Jahre;3958;2021;1937
09679;      Würzburg, Landkreis;3 bis unter 6 Jahre;4027;2043;1984
09679;      Würzburg, Landkreis;6 bis unter 10 Jahre;5783;2969;2814
09679;      Würzburg, Landkreis;10 bis unter 15 Jahre;8247;4301;3946
09679;      Würzburg, Landkreis;15 bis unter 18 Jahre;5293;2696;2597
09679;      Würzburg, Landkreis;18 bis unter 20 Jahre;3781;2001;1780
09679;      Würzburg, Landkreis;20 bis unter 25 Jahre;9410;4789;4621
09679;      Würzburg, Landkreis;25 bis unter 30 Jahre;9020;4634;4386
09679;      Würzburg, Landkreis;30 bis unter 35 Jahre;8906;4462;4444
09679;      Würzburg, Landkreis;35 bis unter 40 Jahre;9141;4557;4584
09679;      Würzburg, Landkreis;40 bis unter 45 Jahre;12335;6070;6265
09679;      Würzburg, Landkreis;45 bis unter 50 Jahre;14368;7163;7205
09679;      Würzburg, Landkreis;50 bis unter 55 Jahre;13783;6883;6900
09679;      Würzburg, Landkreis;55 bis unter 60 Jahre;11515;5738;5777
09679;      Würzburg, Landkreis;60 bis unter 65 Jahre;10225;5105;5120
09679;      Würzburg, Landkreis;65 bis unter 75 Jahre;16011;7881;8130
09679;      Würzburg, Landkreis;75 Jahre und mehr;13999;5841;8158
09679;      Würzburg, Landkreis;Insgesamt;159802;79154;80648
097;    Schwaben, Regierungsbezirk;unter 3 Jahre;45056;22965;22091
097;    Schwaben, Regierungsbezirk;3 bis unter 6 Jahre;46885;23993;22892
097;    Schwaben, Regierungsbezirk;6 bis unter 10 Jahre;66971;34333;32638
097;    Schwaben, Regierungsbezirk;10 bis unter 15 Jahre;95260;48863;46397
097;    Schwaben, Regierungsbezirk;15 bis unter 18 Jahre;60078;30745;29333
097;    Schwaben, Regierungsbezirk;18 bis unter 20 Jahre;42603;21737;20866
097;    Schwaben, Regierungsbezirk;20 bis unter 25 Jahre;109904;56933;52971
097;    Schwaben, Regierungsbezirk;25 bis unter 30 Jahre;104032;53510;50522
097;    Schwaben, Regierungsbezirk;30 bis unter 35 Jahre;103452;52312;51140
097;    Schwaben, Regierungsbezirk;35 bis unter 40 Jahre;105315;53255;52060
097;    Schwaben, Regierungsbezirk;40 bis unter 45 Jahre;140786;71226;69560
097;    Schwaben, Regierungsbezirk;45 bis unter 50 Jahre;154970;78941;76029
097;    Schwaben, Regierungsbezirk;50 bis unter 55 Jahre;137912;69638;68274
097;    Schwaben, Regierungsbezirk;55 bis unter 60 Jahre;114815;57003;57812
097;    Schwaben, Regierungsbezirk;60 bis unter 65 Jahre;104014;51216;52798
097;    Schwaben, Regierungsbezirk;65 bis unter 75 Jahre;193111;92740;100371
097;    Schwaben, Regierungsbezirk;75 Jahre und mehr;164130;63298;100832
097;    Schwaben, Regierungsbezirk;Insgesamt;1789294;882708;906586
09761;      Augsburg, Stadt;unter 3 Jahre;7055;3585;3470
09761;      Augsburg, Stadt;3 bis unter 6 Jahre;6758;3497;3261
09761;      Augsburg, Stadt;6 bis unter 10 Jahre;8597;4352;4245
09761;      Augsburg, Stadt;10 bis unter 15 Jahre;11043;5667;5376
09761;      Augsburg, Stadt;15 bis unter 18 Jahre;7036;3500;3536
09761;      Augsburg, Stadt;18 bis unter 20 Jahre;5741;2841;2900
09761;      Augsburg, Stadt;20 bis unter 25 Jahre;20134;9715;10419
09761;      Augsburg, Stadt;25 bis unter 30 Jahre;20077;10246;9831
09761;      Augsburg, Stadt;30 bis unter 35 Jahre;18182;9391;8791
09761;      Augsburg, Stadt;35 bis unter 40 Jahre;16201;8493;7708
09761;      Augsburg, Stadt;40 bis unter 45 Jahre;19864;10177;9687
09761;      Augsburg, Stadt;45 bis unter 50 Jahre;21691;11310;10381
09761;      Augsburg, Stadt;50 bis unter 55 Jahre;19003;9601;9402
09761;      Augsburg, Stadt;55 bis unter 60 Jahre;15819;7720;8099
09761;      Augsburg, Stadt;60 bis unter 65 Jahre;14919;7014;7905
09761;      Augsburg, Stadt;65 bis unter 75 Jahre;28621;13214;15407
09761;      Augsburg, Stadt;75 Jahre und mehr;25906;9420;16486
09761;      Augsburg, Stadt;Insgesamt;266647;129743;136904
09762;      Kaufbeuren;unter 3 Jahre;1012;506;506
09762;      Kaufbeuren;3 bis unter 6 Jahre;1060;535;525
09762;      Kaufbeuren;6 bis unter 10 Jahre;1499;786;713
09762;      Kaufbeuren;10 bis unter 15 Jahre;2087;1087;1000
09762;      Kaufbeuren;15 bis unter 18 Jahre;1224;630;594
09762;      Kaufbeuren;18 bis unter 20 Jahre;933;469;464
09762;      Kaufbeuren;20 bis unter 25 Jahre;2483;1297;1186
09762;      Kaufbeuren;25 bis unter 30 Jahre;2459;1275;1184
09762;      Kaufbeuren;30 bis unter 35 Jahre;2408;1212;1196
09762;      Kaufbeuren;35 bis unter 40 Jahre;2284;1148;1136
09762;      Kaufbeuren;40 bis unter 45 Jahre;2940;1411;1529
09762;      Kaufbeuren;45 bis unter 50 Jahre;3473;1718;1755
09762;      Kaufbeuren;50 bis unter 55 Jahre;3241;1626;1615
09762;      Kaufbeuren;55 bis unter 60 Jahre;2687;1299;1388
09762;      Kaufbeuren;60 bis unter 65 Jahre;2549;1203;1346
09762;      Kaufbeuren;65 bis unter 75 Jahre;4747;2214;2533
09762;      Kaufbeuren;75 Jahre und mehr;4659;1671;2988
09762;      Kaufbeuren;Insgesamt;41745;20087;21658
09763;      Kempten (Allgäu);unter 3 Jahre;1564;822;742
09763;      Kempten (Allgäu);3 bis unter 6 Jahre;1627;849;778
09763;      Kempten (Allgäu);6 bis unter 10 Jahre;2222;1124;1098
09763;      Kempten (Allgäu);10 bis unter 15 Jahre;2871;1482;1389
09763;      Kempten (Allgäu);15 bis unter 18 Jahre;1827;932;895
09763;      Kempten (Allgäu);18 bis unter 20 Jahre;1414;667;747
09763;      Kempten (Allgäu);20 bis unter 25 Jahre;4371;2254;2117
09763;      Kempten (Allgäu);25 bis unter 30 Jahre;4172;2073;2099
09763;      Kempten (Allgäu);30 bis unter 35 Jahre;3706;1839;1867
09763;      Kempten (Allgäu);35 bis unter 40 Jahre;3331;1663;1668
09763;      Kempten (Allgäu);40 bis unter 45 Jahre;4305;2162;2143
09763;      Kempten (Allgäu);45 bis unter 50 Jahre;4516;2183;2333
09763;      Kempten (Allgäu);50 bis unter 55 Jahre;4318;2103;2215
09763;      Kempten (Allgäu);55 bis unter 60 Jahre;3872;1802;2070
09763;      Kempten (Allgäu);60 bis unter 65 Jahre;3849;1801;2048
09763;      Kempten (Allgäu);65 bis unter 75 Jahre;7598;3533;4065
09763;      Kempten (Allgäu);75 Jahre und mehr;6677;2572;4105
09763;      Kempten (Allgäu);Insgesamt;62240;29861;32379
09764;      Memmingen;unter 3 Jahre;1028;533;495
09764;      Memmingen;3 bis unter 6 Jahre;1059;530;529
09764;      Memmingen;6 bis unter 10 Jahre;1485;746;739
09764;      Memmingen;10 bis unter 15 Jahre;2061;1043;1018
09764;      Memmingen;15 bis unter 18 Jahre;1211;633;578
09764;      Memmingen;18 bis unter 20 Jahre;973;488;485
09764;      Memmingen;20 bis unter 25 Jahre;2482;1289;1193
09764;      Memmingen;25 bis unter 30 Jahre;2487;1234;1253
09764;      Memmingen;30 bis unter 35 Jahre;2670;1408;1262
09764;      Memmingen;35 bis unter 40 Jahre;2377;1233;1144
09764;      Memmingen;40 bis unter 45 Jahre;2954;1555;1399
09764;      Memmingen;45 bis unter 50 Jahre;3252;1639;1613
09764;      Memmingen;50 bis unter 55 Jahre;3110;1536;1574
09764;      Memmingen;55 bis unter 60 Jahre;2642;1261;1381
09764;      Memmingen;60 bis unter 65 Jahre;2394;1146;1248
09764;      Memmingen;65 bis unter 75 Jahre;4686;2193;2493
09764;      Memmingen;75 Jahre und mehr;4159;1483;2676
09764;      Memmingen;Insgesamt;41030;19950;21080
09771;      Aichach-Friedberg, Landkreis;unter 3 Jahre;3248;1618;1630
09771;      Aichach-Friedberg, Landkreis;3 bis unter 6 Jahre;3436;1789;1647
09771;      Aichach-Friedberg, Landkreis;6 bis unter 10 Jahre;5017;2543;2474
09771;      Aichach-Friedberg, Landkreis;10 bis unter 15 Jahre;7418;3814;3604
09771;      Aichach-Friedberg, Landkreis;15 bis unter 18 Jahre;4613;2368;2245
09771;      Aichach-Friedberg, Landkreis;18 bis unter 20 Jahre;3158;1622;1536
09771;      Aichach-Friedberg, Landkreis;20 bis unter 25 Jahre;7387;3838;3549
09771;      Aichach-Friedberg, Landkreis;25 bis unter 30 Jahre;6710;3445;3265
09771;      Aichach-Friedberg, Landkreis;30 bis unter 35 Jahre;7277;3590;3687
09771;      Aichach-Friedberg, Landkreis;35 bis unter 40 Jahre;7781;3914;3867
09771;      Aichach-Friedberg, Landkreis;40 bis unter 45 Jahre;10941;5476;5465
09771;      Aichach-Friedberg, Landkreis;45 bis unter 50 Jahre;11978;6077;5901
09771;      Aichach-Friedberg, Landkreis;50 bis unter 55 Jahre;10369;5253;5116
09771;      Aichach-Friedberg, Landkreis;55 bis unter 60 Jahre;8177;4147;4030
09771;      Aichach-Friedberg, Landkreis;60 bis unter 65 Jahre;7357;3637;3720
09771;      Aichach-Friedberg, Landkreis;65 bis unter 75 Jahre;13300;6484;6816
09771;      Aichach-Friedberg, Landkreis;75 Jahre und mehr;10285;4090;6195
09771;      Aichach-Friedberg, Landkreis;Insgesamt;128452;63705;64747
09772;      Augsburg, Landkreis;unter 3 Jahre;5900;3009;2891
09772;      Augsburg, Landkreis;3 bis unter 6 Jahre;6406;3323;3083
09772;      Augsburg, Landkreis;6 bis unter 10 Jahre;9279;4754;4525
09772;      Augsburg, Landkreis;10 bis unter 15 Jahre;13358;6807;6551
09772;      Augsburg, Landkreis;15 bis unter 18 Jahre;8657;4497;4160
09772;      Augsburg, Landkreis;18 bis unter 20 Jahre;6038;3051;2987
09772;      Augsburg, Landkreis;20 bis unter 25 Jahre;13822;7242;6580
09772;      Augsburg, Landkreis;25 bis unter 30 Jahre;12449;6303;6146
09772;      Augsburg, Landkreis;30 bis unter 35 Jahre;13062;6467;6595
09772;      Augsburg, Landkreis;35 bis unter 40 Jahre;14118;6971;7147
09772;      Augsburg, Landkreis;40 bis unter 45 Jahre;19786;9861;9925
09772;      Augsburg, Landkreis;45 bis unter 50 Jahre;22109;11129;10980
09772;      Augsburg, Landkreis;50 bis unter 55 Jahre;19417;9955;9462
09772;      Augsburg, Landkreis;55 bis unter 60 Jahre;15807;7824;7983
09772;      Augsburg, Landkreis;60 bis unter 65 Jahre;13987;6906;7081
09772;      Augsburg, Landkreis;65 bis unter 75 Jahre;26055;12642;13413
09772;      Augsburg, Landkreis;75 Jahre und mehr;20700;8132;12568
09772;      Augsburg, Landkreis;Insgesamt;240950;118873;122077
09773;      Dillingen a.d.Donau, Landkreis;unter 3 Jahre;2363;1215;1148
09773;      Dillingen a.d.Donau, Landkreis;3 bis unter 6 Jahre;2426;1241;1185
09773;      Dillingen a.d.Donau, Landkreis;6 bis unter 10 Jahre;3725;1917;1808
09773;      Dillingen a.d.Donau, Landkreis;10 bis unter 15 Jahre;5328;2718;2610
09773;      Dillingen a.d.Donau, Landkreis;15 bis unter 18 Jahre;3583;1818;1765
09773;      Dillingen a.d.Donau, Landkreis;18 bis unter 20 Jahre;2462;1276;1186
09773;      Dillingen a.d.Donau, Landkreis;20 bis unter 25 Jahre;5748;3088;2660
09773;      Dillingen a.d.Donau, Landkreis;25 bis unter 30 Jahre;5131;2734;2397
09773;      Dillingen a.d.Donau, Landkreis;30 bis unter 35 Jahre;5180;2650;2530
09773;      Dillingen a.d.Donau, Landkreis;35 bis unter 40 Jahre;5526;2762;2764
09773;      Dillingen a.d.Donau, Landkreis;40 bis unter 45 Jahre;7338;3769;3569
09773;      Dillingen a.d.Donau, Landkreis;45 bis unter 50 Jahre;8153;4136;4017
09773;      Dillingen a.d.Donau, Landkreis;50 bis unter 55 Jahre;7416;3726;3690
09773;      Dillingen a.d.Donau, Landkreis;55 bis unter 60 Jahre;6328;3163;3165
09773;      Dillingen a.d.Donau, Landkreis;60 bis unter 65 Jahre;5392;2719;2673
09773;      Dillingen a.d.Donau, Landkreis;65 bis unter 75 Jahre;8959;4340;4619
09773;      Dillingen a.d.Donau, Landkreis;75 Jahre und mehr;8163;3114;5049
09773;      Dillingen a.d.Donau, Landkreis;Insgesamt;93221;46386;46835
09774;      Günzburg, Landkreis;unter 3 Jahre;3173;1616;1557
09774;      Günzburg, Landkreis;3 bis unter 6 Jahre;3214;1665;1549
09774;      Günzburg, Landkreis;6 bis unter 10 Jahre;4692;2428;2264
09774;      Günzburg, Landkreis;10 bis unter 15 Jahre;6773;3529;3244
09774;      Günzburg, Landkreis;15 bis unter 18 Jahre;4288;2196;2092
09774;      Günzburg, Landkreis;18 bis unter 20 Jahre;2967;1555;1412
09774;      Günzburg, Landkreis;20 bis unter 25 Jahre;7401;3888;3513
09774;      Günzburg, Landkreis;25 bis unter 30 Jahre;6787;3533;3254
09774;      Günzburg, Landkreis;30 bis unter 35 Jahre;6718;3419;3299
09774;      Günzburg, Landkreis;35 bis unter 40 Jahre;7227;3632;3595
09774;      Günzburg, Landkreis;40 bis unter 45 Jahre;9610;4910;4700
09774;      Günzburg, Landkreis;45 bis unter 50 Jahre;10727;5458;5269
09774;      Günzburg, Landkreis;50 bis unter 55 Jahre;9637;4853;4784
09774;      Günzburg, Landkreis;55 bis unter 60 Jahre;8046;4110;3936
09774;      Günzburg, Landkreis;60 bis unter 65 Jahre;6714;3406;3308
09774;      Günzburg, Landkreis;65 bis unter 75 Jahre;11913;5835;6078
09774;      Günzburg, Landkreis;75 Jahre und mehr;10297;3926;6371
09774;      Günzburg, Landkreis;Insgesamt;120184;59959;60225
09775;      Neu-Ulm, Landkreis;unter 3 Jahre;4421;2233;2188
09775;      Neu-Ulm, Landkreis;3 bis unter 6 Jahre;4479;2233;2246
09775;      Neu-Ulm, Landkreis;6 bis unter 10 Jahre;6345;3278;3067
09775;      Neu-Ulm, Landkreis;10 bis unter 15 Jahre;8739;4454;4285
09775;      Neu-Ulm, Landkreis;15 bis unter 18 Jahre;5358;2739;2619
09775;      Neu-Ulm, Landkreis;18 bis unter 20 Jahre;3711;2000;1711
09775;      Neu-Ulm, Landkreis;20 bis unter 25 Jahre;10062;5190;4872
09775;      Neu-Ulm, Landkreis;25 bis unter 30 Jahre;10304;5230;5074
09775;      Neu-Ulm, Landkreis;30 bis unter 35 Jahre;10017;5148;4869
09775;      Neu-Ulm, Landkreis;35 bis unter 40 Jahre;9996;5107;4889
09775;      Neu-Ulm, Landkreis;40 bis unter 45 Jahre;12964;6649;6315
09775;      Neu-Ulm, Landkreis;45 bis unter 50 Jahre;14086;7271;6815
09775;      Neu-Ulm, Landkreis;50 bis unter 55 Jahre;12828;6516;6312
09775;      Neu-Ulm, Landkreis;55 bis unter 60 Jahre;11044;5448;5596
09775;      Neu-Ulm, Landkreis;60 bis unter 65 Jahre;9727;4833;4894
09775;      Neu-Ulm, Landkreis;65 bis unter 75 Jahre;17835;8634;9201
09775;      Neu-Ulm, Landkreis;75 Jahre und mehr;14230;5644;8586
09775;      Neu-Ulm, Landkreis;Insgesamt;166146;82607;83539
09776;      Lindau (Bodensee), Landkreis;unter 3 Jahre;1805;917;888
09776;      Lindau (Bodensee), Landkreis;3 bis unter 6 Jahre;2000;974;1026
09776;      Lindau (Bodensee), Landkreis;6 bis unter 10 Jahre;2978;1573;1405
09776;      Lindau (Bodensee), Landkreis;10 bis unter 15 Jahre;4432;2255;2177
09776;      Lindau (Bodensee), Landkreis;15 bis unter 18 Jahre;2752;1378;1374
09776;      Lindau (Bodensee), Landkreis;18 bis unter 20 Jahre;1787;892;895
09776;      Lindau (Bodensee), Landkreis;20 bis unter 25 Jahre;4384;2288;2096
09776;      Lindau (Bodensee), Landkreis;25 bis unter 30 Jahre;4055;2117;1938
09776;      Lindau (Bodensee), Landkreis;30 bis unter 35 Jahre;4318;2122;2196
09776;      Lindau (Bodensee), Landkreis;35 bis unter 40 Jahre;4452;2183;2269
09776;      Lindau (Bodensee), Landkreis;40 bis unter 45 Jahre;6521;3295;3226
09776;      Lindau (Bodensee), Landkreis;45 bis unter 50 Jahre;7179;3571;3608
09776;      Lindau (Bodensee), Landkreis;50 bis unter 55 Jahre;6090;3044;3046
09776;      Lindau (Bodensee), Landkreis;55 bis unter 60 Jahre;4811;2395;2416
09776;      Lindau (Bodensee), Landkreis;60 bis unter 65 Jahre;4678;2276;2402
09776;      Lindau (Bodensee), Landkreis;65 bis unter 75 Jahre;9442;4553;4889
09776;      Lindau (Bodensee), Landkreis;75 Jahre und mehr;8211;3243;4968
09776;      Lindau (Bodensee), Landkreis;Insgesamt;79895;39076;40819
09777;      Ostallgäu, Landkreis;unter 3 Jahre;3315;1664;1651
09777;      Ostallgäu, Landkreis;3 bis unter 6 Jahre;3653;1839;1814
09777;      Ostallgäu, Landkreis;6 bis unter 10 Jahre;5318;2736;2582
09777;      Ostallgäu, Landkreis;10 bis unter 15 Jahre;7668;3883;3785
09777;      Ostallgäu, Landkreis;15 bis unter 18 Jahre;4802;2487;2315
09777;      Ostallgäu, Landkreis;18 bis unter 20 Jahre;3342;1695;1647
09777;      Ostallgäu, Landkreis;20 bis unter 25 Jahre;7633;4024;3609
09777;      Ostallgäu, Landkreis;25 bis unter 30 Jahre;7174;3752;3422
09777;      Ostallgäu, Landkreis;30 bis unter 35 Jahre;7279;3683;3596
09777;      Ostallgäu, Landkreis;35 bis unter 40 Jahre;7757;3838;3919
09777;      Ostallgäu, Landkreis;40 bis unter 45 Jahre;10524;5339;5185
09777;      Ostallgäu, Landkreis;45 bis unter 50 Jahre;11798;5896;5902
09777;      Ostallgäu, Landkreis;50 bis unter 55 Jahre;10250;5158;5092
09777;      Ostallgäu, Landkreis;55 bis unter 60 Jahre;8664;4325;4339
09777;      Ostallgäu, Landkreis;60 bis unter 65 Jahre;7957;4040;3917
09777;      Ostallgäu, Landkreis;65 bis unter 75 Jahre;14531;7109;7422
09777;      Ostallgäu, Landkreis;75 Jahre und mehr;12314;4918;7396
09777;      Ostallgäu, Landkreis;Insgesamt;133979;66386;67593
09778;      Unterallgäu, Landkreis;unter 3 Jahre;3449;1775;1674
09778;      Unterallgäu, Landkreis;3 bis unter 6 Jahre;3588;1843;1745
09778;      Unterallgäu, Landkreis;6 bis unter 10 Jahre;5233;2654;2579
09778;      Unterallgäu, Landkreis;10 bis unter 15 Jahre;8034;4168;3866
09778;      Unterallgäu, Landkreis;15 bis unter 18 Jahre;5079;2580;2499
09778;      Unterallgäu, Landkreis;18 bis unter 20 Jahre;3435;1762;1673
09778;      Unterallgäu, Landkreis;20 bis unter 25 Jahre;7919;4148;3771
09778;      Unterallgäu, Landkreis;25 bis unter 30 Jahre;7098;3685;3413
09778;      Unterallgäu, Landkreis;30 bis unter 35 Jahre;7225;3692;3533
09778;      Unterallgäu, Landkreis;35 bis unter 40 Jahre;7833;4022;3811
09778;      Unterallgäu, Landkreis;40 bis unter 45 Jahre;10787;5473;5314
09778;      Unterallgäu, Landkreis;45 bis unter 50 Jahre;11744;6093;5651
09778;      Unterallgäu, Landkreis;50 bis unter 55 Jahre;10358;5225;5133
09778;      Unterallgäu, Landkreis;55 bis unter 60 Jahre;8649;4368;4281
09778;      Unterallgäu, Landkreis;60 bis unter 65 Jahre;7885;4005;3880
09778;      Unterallgäu, Landkreis;65 bis unter 75 Jahre;14521;6957;7564
09778;      Unterallgäu, Landkreis;75 Jahre und mehr;12899;5054;7845
09778;      Unterallgäu, Landkreis;Insgesamt;135736;67504;68232
09779;      Donau-Ries, Landkreis;unter 3 Jahre;3267;1681;1586
09779;      Donau-Ries, Landkreis;3 bis unter 6 Jahre;3441;1721;1720
09779;      Donau-Ries, Landkreis;6 bis unter 10 Jahre;5119;2649;2470
09779;      Donau-Ries, Landkreis;10 bis unter 15 Jahre;7255;3738;3517
09779;      Donau-Ries, Landkreis;15 bis unter 18 Jahre;4525;2323;2202
09779;      Donau-Ries, Landkreis;18 bis unter 20 Jahre;3091;1584;1507
09779;      Donau-Ries, Landkreis;20 bis unter 25 Jahre;7728;4221;3507
09779;      Donau-Ries, Landkreis;25 bis unter 30 Jahre;7462;3983;3479
09779;      Donau-Ries, Landkreis;30 bis unter 35 Jahre;7419;3838;3581
09779;      Donau-Ries, Landkreis;35 bis unter 40 Jahre;7911;4107;3804
09779;      Donau-Ries, Landkreis;40 bis unter 45 Jahre;10095;5239;4856
09779;      Donau-Ries, Landkreis;45 bis unter 50 Jahre;11174;5834;5340
09779;      Donau-Ries, Landkreis;50 bis unter 55 Jahre;10151;5252;4899
09779;      Donau-Ries, Landkreis;55 bis unter 60 Jahre;8702;4480;4222
09779;      Donau-Ries, Landkreis;60 bis unter 65 Jahre;7266;3748;3518
09779;      Donau-Ries, Landkreis;65 bis unter 75 Jahre;13016;6390;6626
09779;      Donau-Ries, Landkreis;75 Jahre und mehr;11501;4466;7035
09779;      Donau-Ries, Landkreis;Insgesamt;129123;65254;63869
09780;      Oberallgäu, Landkreis;unter 3 Jahre;3456;1791;1665
09780;      Oberallgäu, Landkreis;3 bis unter 6 Jahre;3738;1954;1784
09780;      Oberallgäu, Landkreis;6 bis unter 10 Jahre;5462;2793;2669
09780;      Oberallgäu, Landkreis;10 bis unter 15 Jahre;8193;4218;3975
09780;      Oberallgäu, Landkreis;15 bis unter 18 Jahre;5123;2664;2459
09780;      Oberallgäu, Landkreis;18 bis unter 20 Jahre;3551;1835;1716
09780;      Oberallgäu, Landkreis;20 bis unter 25 Jahre;8350;4451;3899
09780;      Oberallgäu, Landkreis;25 bis unter 30 Jahre;7667;3900;3767
09780;      Oberallgäu, Landkreis;30 bis unter 35 Jahre;7991;3853;4138
09780;      Oberallgäu, Landkreis;35 bis unter 40 Jahre;8521;4182;4339
09780;      Oberallgäu, Landkreis;40 bis unter 45 Jahre;12157;5910;6247
09780;      Oberallgäu, Landkreis;45 bis unter 50 Jahre;13090;6626;6464
09780;      Oberallgäu, Landkreis;50 bis unter 55 Jahre;11724;5790;5934
09780;      Oberallgäu, Landkreis;55 bis unter 60 Jahre;9567;4661;4906
09780;      Oberallgäu, Landkreis;60 bis unter 65 Jahre;9340;4482;4858
09780;      Oberallgäu, Landkreis;65 bis unter 75 Jahre;17887;8642;9245
09780;      Oberallgäu, Landkreis;75 Jahre und mehr;14129;5565;8564
09780;      Oberallgäu, Landkreis;Insgesamt;149946;73317;76629
10;  Saarland;unter 3 Jahre;21135;10771;10364
10;  Saarland;3 bis unter 6 Jahre;21719;11283;10436
10;  Saarland;6 bis unter 10 Jahre;30913;15900;15013
10;  Saarland;10 bis unter 15 Jahre;45445;23052;22393
10;  Saarland;15 bis unter 18 Jahre;30414;15500;14914
10;  Saarland;18 bis unter 20 Jahre;22214;11386;10828
10;  Saarland;20 bis unter 25 Jahre;59700;30746;28954
10;  Saarland;25 bis unter 30 Jahre;58039;29912;28127
10;  Saarland;30 bis unter 35 Jahre;55602;28273;27329
10;  Saarland;35 bis unter 40 Jahre;52940;26723;26217
10;  Saarland;40 bis unter 45 Jahre;73660;37087;36573
10;  Saarland;45 bis unter 50 Jahre;88498;44175;44323
10;  Saarland;50 bis unter 55 Jahre;86697;43688;43009
10;  Saarland;55 bis unter 60 Jahre;76527;38218;38309
10;  Saarland;60 bis unter 65 Jahre;67429;33495;33934
10;  Saarland;65 bis unter 75 Jahre;113517;52442;61075
10;  Saarland;75 Jahre und mehr;108903;41063;67840
10;  Saarland;Insgesamt;1013352;493714;519638
10041;      Saarbrücken, Regionalverband;unter 3 Jahre;7221;3725;3496
10041;      Saarbrücken, Regionalverband;3 bis unter 6 Jahre;7088;3719;3369
10041;      Saarbrücken, Regionalverband;6 bis unter 10 Jahre;9909;5123;4786
10041;      Saarbrücken, Regionalverband;10 bis unter 15 Jahre;14272;7165;7107
10041;      Saarbrücken, Regionalverband;15 bis unter 18 Jahre;9317;4771;4546
10041;      Saarbrücken, Regionalverband;18 bis unter 20 Jahre;7061;3574;3487
10041;      Saarbrücken, Regionalverband;20 bis unter 25 Jahre;21125;10512;10613
10041;      Saarbrücken, Regionalverband;25 bis unter 30 Jahre;21455;10893;10562
10041;      Saarbrücken, Regionalverband;30 bis unter 35 Jahre;19399;9918;9481
10041;      Saarbrücken, Regionalverband;35 bis unter 40 Jahre;17343;8828;8515
10041;      Saarbrücken, Regionalverband;40 bis unter 45 Jahre;23288;11663;11625
10041;      Saarbrücken, Regionalverband;45 bis unter 50 Jahre;28653;14134;14519
10041;      Saarbrücken, Regionalverband;50 bis unter 55 Jahre;27575;13756;13819
10041;      Saarbrücken, Regionalverband;55 bis unter 60 Jahre;23928;11827;12101
10041;      Saarbrücken, Regionalverband;60 bis unter 65 Jahre;22128;10726;11402
10041;      Saarbrücken, Regionalverband;65 bis unter 75 Jahre;36996;16934;20062
10041;      Saarbrücken, Regionalverband;75 Jahre und mehr;34771;12751;22020
10041;      Saarbrücken, Regionalverband;Insgesamt;331529;160019;171510
10041100;      Saarbrücken, Landeshauptstadt;unter 3 Jahre;4111;2115;1996
10041100;      Saarbrücken, Landeshauptstadt;3 bis unter 6 Jahre;3897;2056;1841
10041100;      Saarbrücken, Landeshauptstadt;6 bis unter 10 Jahre;5309;2774;2535
10041100;      Saarbrücken, Landeshauptstadt;10 bis unter 15 Jahre;7215;3642;3573
10041100;      Saarbrücken, Landeshauptstadt;15 bis unter 18 Jahre;4531;2287;2244
10041100;      Saarbrücken, Landeshauptstadt;18 bis unter 20 Jahre;3536;1778;1758
10041100;      Saarbrücken, Landeshauptstadt;20 bis unter 25 Jahre;12614;6149;6465
10041100;      Saarbrücken, Landeshauptstadt;25 bis unter 30 Jahre;13524;6880;6644
10041100;      Saarbrücken, Landeshauptstadt;30 bis unter 35 Jahre;11427;5905;5522
10041100;      Saarbrücken, Landeshauptstadt;35 bis unter 40 Jahre;9495;4849;4646
10041100;      Saarbrücken, Landeshauptstadt;40 bis unter 45 Jahre;11850;6001;5849
10041100;      Saarbrücken, Landeshauptstadt;45 bis unter 50 Jahre;15215;7439;7776
10041100;      Saarbrücken, Landeshauptstadt;50 bis unter 55 Jahre;14238;7065;7173
10041100;      Saarbrücken, Landeshauptstadt;55 bis unter 60 Jahre;12233;6067;6166
10041100;      Saarbrücken, Landeshauptstadt;60 bis unter 65 Jahre;10976;5290;5686
10041100;      Saarbrücken, Landeshauptstadt;65 bis unter 75 Jahre;18663;8477;10186
10041100;      Saarbrücken, Landeshauptstadt;75 Jahre und mehr;17301;6246;11055
10041100;      Saarbrücken, Landeshauptstadt;Insgesamt;176135;85020;91115
10042;      Merzig-Wadern, Landkreis;unter 3 Jahre;2269;1166;1103
10042;      Merzig-Wadern, Landkreis;3 bis unter 6 Jahre;2368;1238;1130
10042;      Merzig-Wadern, Landkreis;6 bis unter 10 Jahre;3657;1876;1781
10042;      Merzig-Wadern, Landkreis;10 bis unter 15 Jahre;5156;2577;2579
10042;      Merzig-Wadern, Landkreis;15 bis unter 18 Jahre;3420;1757;1663
10042;      Merzig-Wadern, Landkreis;18 bis unter 20 Jahre;2314;1193;1121
10042;      Merzig-Wadern, Landkreis;20 bis unter 25 Jahre;5732;3048;2684
10042;      Merzig-Wadern, Landkreis;25 bis unter 30 Jahre;5439;2796;2643
10042;      Merzig-Wadern, Landkreis;30 bis unter 35 Jahre;5761;2907;2854
10042;      Merzig-Wadern, Landkreis;35 bis unter 40 Jahre;5912;2990;2922
10042;      Merzig-Wadern, Landkreis;40 bis unter 45 Jahre;7929;4024;3905
10042;      Merzig-Wadern, Landkreis;45 bis unter 50 Jahre;9013;4539;4474
10042;      Merzig-Wadern, Landkreis;50 bis unter 55 Jahre;8949;4611;4338
10042;      Merzig-Wadern, Landkreis;55 bis unter 60 Jahre;8108;4129;3979
10042;      Merzig-Wadern, Landkreis;60 bis unter 65 Jahre;6766;3417;3349
10042;      Merzig-Wadern, Landkreis;65 bis unter 75 Jahre;11042;5128;5914
10042;      Merzig-Wadern, Landkreis;75 Jahre und mehr;10754;4080;6674
10042;      Merzig-Wadern, Landkreis;Insgesamt;104589;51476;53113
10043;      Neunkirchen, Landkreis;unter 3 Jahre;2716;1351;1365
10043;      Neunkirchen, Landkreis;3 bis unter 6 Jahre;2882;1519;1363
10043;      Neunkirchen, Landkreis;6 bis unter 10 Jahre;4012;2106;1906
10043;      Neunkirchen, Landkreis;10 bis unter 15 Jahre;6102;3135;2967
10043;      Neunkirchen, Landkreis;15 bis unter 18 Jahre;4023;2008;2015
10043;      Neunkirchen, Landkreis;18 bis unter 20 Jahre;2966;1555;1411
10043;      Neunkirchen, Landkreis;20 bis unter 25 Jahre;7805;4084;3721
10043;      Neunkirchen, Landkreis;25 bis unter 30 Jahre;7400;3859;3541
10043;      Neunkirchen, Landkreis;30 bis unter 35 Jahre;7078;3602;3476
10043;      Neunkirchen, Landkreis;35 bis unter 40 Jahre;6825;3364;3461
10043;      Neunkirchen, Landkreis;40 bis unter 45 Jahre;9954;5006;4948
10043;      Neunkirchen, Landkreis;45 bis unter 50 Jahre;11965;5999;5966
10043;      Neunkirchen, Landkreis;50 bis unter 55 Jahre;11923;6052;5871
10043;      Neunkirchen, Landkreis;55 bis unter 60 Jahre;10381;5163;5218
10043;      Neunkirchen, Landkreis;60 bis unter 65 Jahre;9189;4617;4572
10043;      Neunkirchen, Landkreis;65 bis unter 75 Jahre;16011;7360;8651
10043;      Neunkirchen, Landkreis;75 Jahre und mehr;15149;5755;9394
10043;      Neunkirchen, Landkreis;Insgesamt;136381;66535;69846
10044;      Saarlouis, Landkreis;unter 3 Jahre;4224;2122;2102
10044;      Saarlouis, Landkreis;3 bis unter 6 Jahre;4402;2311;2091
10044;      Saarlouis, Landkreis;6 bis unter 10 Jahre;6182;3163;3019
10044;      Saarlouis, Landkreis;10 bis unter 15 Jahre;9261;4703;4558
10044;      Saarlouis, Landkreis;15 bis unter 18 Jahre;6227;3122;3105
10044;      Saarlouis, Landkreis;18 bis unter 20 Jahre;4518;2355;2163
10044;      Saarlouis, Landkreis;20 bis unter 25 Jahre;11598;6073;5525
10044;      Saarlouis, Landkreis;25 bis unter 30 Jahre;11099;5832;5267
10044;      Saarlouis, Landkreis;30 bis unter 35 Jahre;10973;5644;5329
10044;      Saarlouis, Landkreis;35 bis unter 40 Jahre;10631;5369;5262
10044;      Saarlouis, Landkreis;40 bis unter 45 Jahre;14754;7450;7304
10044;      Saarlouis, Landkreis;45 bis unter 50 Jahre;17709;8994;8715
10044;      Saarlouis, Landkreis;50 bis unter 55 Jahre;17473;8721;8752
10044;      Saarlouis, Landkreis;55 bis unter 60 Jahre;15769;7910;7859
10044;      Saarlouis, Landkreis;60 bis unter 65 Jahre;13526;6835;6691
10044;      Saarlouis, Landkreis;65 bis unter 75 Jahre;22476;10348;12128
10044;      Saarlouis, Landkreis;75 Jahre und mehr;21530;8150;13380
10044;      Saarlouis, Landkreis;Insgesamt;202352;99102;103250
10045;      Saarpfalz-Kreis;unter 3 Jahre;2968;1523;1445
10045;      Saarpfalz-Kreis;3 bis unter 6 Jahre;3141;1589;1552
10045;      Saarpfalz-Kreis;6 bis unter 10 Jahre;4340;2196;2144
10045;      Saarpfalz-Kreis;10 bis unter 15 Jahre;6562;3370;3192
10045;      Saarpfalz-Kreis;15 bis unter 18 Jahre;4535;2351;2184
10045;      Saarpfalz-Kreis;18 bis unter 20 Jahre;3238;1621;1617
10045;      Saarpfalz-Kreis;20 bis unter 25 Jahre;8434;4358;4076
10045;      Saarpfalz-Kreis;25 bis unter 30 Jahre;8017;4122;3895
10045;      Saarpfalz-Kreis;30 bis unter 35 Jahre;7730;3896;3834
10045;      Saarpfalz-Kreis;35 bis unter 40 Jahre;7544;3804;3740
10045;      Saarpfalz-Kreis;40 bis unter 45 Jahre;11040;5547;5493
10045;      Saarpfalz-Kreis;45 bis unter 50 Jahre;13203;6531;6672
10045;      Saarpfalz-Kreis;50 bis unter 55 Jahre;12838;6452;6386
10045;      Saarpfalz-Kreis;55 bis unter 60 Jahre;11198;5546;5652
10045;      Saarpfalz-Kreis;60 bis unter 65 Jahre;9857;4890;4967
10045;      Saarpfalz-Kreis;65 bis unter 75 Jahre;17045;7894;9151
10045;      Saarpfalz-Kreis;75 Jahre und mehr;16929;6540;10389
10045;      Saarpfalz-Kreis;Insgesamt;148619;72230;76389
10046;      St. Wendel, Landkreis;unter 3 Jahre;1737;884;853
10046;      St. Wendel, Landkreis;3 bis unter 6 Jahre;1838;907;931
10046;      St. Wendel, Landkreis;6 bis unter 10 Jahre;2813;1436;1377
10046;      St. Wendel, Landkreis;10 bis unter 15 Jahre;4092;2102;1990
10046;      St. Wendel, Landkreis;15 bis unter 18 Jahre;2892;1491;1401
10046;      St. Wendel, Landkreis;18 bis unter 20 Jahre;2117;1088;1029
10046;      St. Wendel, Landkreis;20 bis unter 25 Jahre;5006;2671;2335
10046;      St. Wendel, Landkreis;25 bis unter 30 Jahre;4629;2410;2219
10046;      St. Wendel, Landkreis;30 bis unter 35 Jahre;4661;2306;2355
10046;      St. Wendel, Landkreis;35 bis unter 40 Jahre;4685;2368;2317
10046;      St. Wendel, Landkreis;40 bis unter 45 Jahre;6695;3397;3298
10046;      St. Wendel, Landkreis;45 bis unter 50 Jahre;7955;3978;3977
10046;      St. Wendel, Landkreis;50 bis unter 55 Jahre;7939;4096;3843
10046;      St. Wendel, Landkreis;55 bis unter 60 Jahre;7143;3643;3500
10046;      St. Wendel, Landkreis;60 bis unter 65 Jahre;5963;3010;2953
10046;      St. Wendel, Landkreis;65 bis unter 75 Jahre;9947;4778;5169
10046;      St. Wendel, Landkreis;75 Jahre und mehr;9770;3787;5983
10046;      St. Wendel, Landkreis;Insgesamt;89882;44352;45530
11000;  Berlin;unter 3 Jahre;98118;50303;47815
11000;  Berlin;3 bis unter 6 Jahre;91822;47320;44502
11000;  Berlin;6 bis unter 10 Jahre;109273;56221;53052
11000;  Berlin;10 bis unter 15 Jahre;133246;68201;65045
11000;  Berlin;15 bis unter 18 Jahre;77317;39665;37652
11000;  Berlin;18 bis unter 20 Jahre;57041;28876;28165
11000;  Berlin;20 bis unter 25 Jahre;231178;112278;118900
11000;  Berlin;25 bis unter 30 Jahre;284687;140575;144112
11000;  Berlin;30 bis unter 35 Jahre;276989;141188;135801
11000;  Berlin;35 bis unter 40 Jahre;232551;120445;112106
11000;  Berlin;40 bis unter 45 Jahre;270099;140902;129197
11000;  Berlin;45 bis unter 50 Jahre;307041;158015;149026
11000;  Berlin;50 bis unter 55 Jahre;253595;129132;124463
11000;  Berlin;55 bis unter 60 Jahre;215153;105508;109645
11000;  Berlin;60 bis unter 65 Jahre;200495;95593;104902
11000;  Berlin;65 bis unter 75 Jahre;384343;180196;204147
11000;  Berlin;75 Jahre und mehr;278924;103227;175697
11000;  Berlin;Insgesamt;3501872;1717645;1784227
12;  Brandenburg;unter 3 Jahre;57489;29483;28006
12;  Brandenburg;3 bis unter 6 Jahre;59272;30420;28852
12;  Brandenburg;6 bis unter 10 Jahre;78584;40432;38152
12;  Brandenburg;10 bis unter 15 Jahre;98326;50240;48086
12;  Brandenburg;15 bis unter 18 Jahre;50258;26025;24233
12;  Brandenburg;18 bis unter 20 Jahre;31603;16441;15162
12;  Brandenburg;20 bis unter 25 Jahre;134098;71260;62838
12;  Brandenburg;25 bis unter 30 Jahre;140052;74937;65115
12;  Brandenburg;30 bis unter 35 Jahre;141470;73958;67512
12;  Brandenburg;35 bis unter 40 Jahre;128617;66839;61778
12;  Brandenburg;40 bis unter 45 Jahre;186292;95783;90509
12;  Brandenburg;45 bis unter 50 Jahre;240813;123754;117059
12;  Brandenburg;50 bis unter 55 Jahre;228422;117298;111124
12;  Brandenburg;55 bis unter 60 Jahre;204793;103622;101171
12;  Brandenburg;60 bis unter 65 Jahre;157062;78249;78813
12;  Brandenburg;65 bis unter 75 Jahre;310539;145090;165449
12;  Brandenburg;75 Jahre und mehr;247945;92916;155029
12;  Brandenburg;Insgesamt;2495635;1236747;1258888
12051;      Brandenburg an der Havel, Kreisfreie Stadt;unter 3 Jahre;1681;842;839
12051;      Brandenburg an der Havel, Kreisfreie Stadt;3 bis unter 6 Jahre;1623;826;797
12051;      Brandenburg an der Havel, Kreisfreie Stadt;6 bis unter 10 Jahre;1870;932;938
12051;      Brandenburg an der Havel, Kreisfreie Stadt;10 bis unter 15 Jahre;2228;1175;1053
12051;      Brandenburg an der Havel, Kreisfreie Stadt;15 bis unter 18 Jahre;1179;636;543
12051;      Brandenburg an der Havel, Kreisfreie Stadt;18 bis unter 20 Jahre;830;409;421
12051;      Brandenburg an der Havel, Kreisfreie Stadt;20 bis unter 25 Jahre;4429;2343;2086
12051;      Brandenburg an der Havel, Kreisfreie Stadt;25 bis unter 30 Jahre;4796;2506;2290
12051;      Brandenburg an der Havel, Kreisfreie Stadt;30 bis unter 35 Jahre;4239;2347;1892
12051;      Brandenburg an der Havel, Kreisfreie Stadt;35 bis unter 40 Jahre;3142;1722;1420
12051;      Brandenburg an der Havel, Kreisfreie Stadt;40 bis unter 45 Jahre;4478;2317;2161
12051;      Brandenburg an der Havel, Kreisfreie Stadt;45 bis unter 50 Jahre;6027;3102;2925
12051;      Brandenburg an der Havel, Kreisfreie Stadt;50 bis unter 55 Jahre;6026;3036;2990
12051;      Brandenburg an der Havel, Kreisfreie Stadt;55 bis unter 60 Jahre;5614;2791;2823
12051;      Brandenburg an der Havel, Kreisfreie Stadt;60 bis unter 65 Jahre;4445;2174;2271
12051;      Brandenburg an der Havel, Kreisfreie Stadt;65 bis unter 75 Jahre;10653;4934;5719
12051;      Brandenburg an der Havel, Kreisfreie Stadt;75 Jahre und mehr;8274;3035;5239
12051;      Brandenburg an der Havel, Kreisfreie Stadt;Insgesamt;71534;35127;36407
12052;      Cottbus, Kreisfreie Stadt;unter 3 Jahre;2359;1187;1172
12052;      Cottbus, Kreisfreie Stadt;3 bis unter 6 Jahre;2121;1074;1047
12052;      Cottbus, Kreisfreie Stadt;6 bis unter 10 Jahre;2701;1394;1307
12052;      Cottbus, Kreisfreie Stadt;10 bis unter 15 Jahre;3224;1663;1561
12052;      Cottbus, Kreisfreie Stadt;15 bis unter 18 Jahre;1629;853;776
12052;      Cottbus, Kreisfreie Stadt;18 bis unter 20 Jahre;1247;633;614
12052;      Cottbus, Kreisfreie Stadt;20 bis unter 25 Jahre;8159;4343;3816
12052;      Cottbus, Kreisfreie Stadt;25 bis unter 30 Jahre;7761;4400;3361
12052;      Cottbus, Kreisfreie Stadt;30 bis unter 35 Jahre;6451;3533;2918
12052;      Cottbus, Kreisfreie Stadt;35 bis unter 40 Jahre;4918;2629;2289
12052;      Cottbus, Kreisfreie Stadt;40 bis unter 45 Jahre;6762;3522;3240
12052;      Cottbus, Kreisfreie Stadt;45 bis unter 50 Jahre;8636;4347;4289
12052;      Cottbus, Kreisfreie Stadt;50 bis unter 55 Jahre;8544;4250;4294
12052;      Cottbus, Kreisfreie Stadt;55 bis unter 60 Jahre;8092;3855;4237
12052;      Cottbus, Kreisfreie Stadt;60 bis unter 65 Jahre;6366;3072;3294
12052;      Cottbus, Kreisfreie Stadt;65 bis unter 75 Jahre;12889;5838;7051
12052;      Cottbus, Kreisfreie Stadt;75 Jahre und mehr;10270;3745;6525
12052;      Cottbus, Kreisfreie Stadt;Insgesamt;102129;50338;51791
12053;      Frankfurt (Oder), Kreisfreie Stadt;unter 3 Jahre;1327;675;652
12053;      Frankfurt (Oder), Kreisfreie Stadt;3 bis unter 6 Jahre;1385;714;671
12053;      Frankfurt (Oder), Kreisfreie Stadt;6 bis unter 10 Jahre;1652;864;788
12053;      Frankfurt (Oder), Kreisfreie Stadt;10 bis unter 15 Jahre;2004;999;1005
12053;      Frankfurt (Oder), Kreisfreie Stadt;15 bis unter 18 Jahre;1102;554;548
12053;      Frankfurt (Oder), Kreisfreie Stadt;18 bis unter 20 Jahre;758;399;359
12053;      Frankfurt (Oder), Kreisfreie Stadt;20 bis unter 25 Jahre;4193;2061;2132
12053;      Frankfurt (Oder), Kreisfreie Stadt;25 bis unter 30 Jahre;4015;2174;1841
12053;      Frankfurt (Oder), Kreisfreie Stadt;30 bis unter 35 Jahre;3478;1879;1599
12053;      Frankfurt (Oder), Kreisfreie Stadt;35 bis unter 40 Jahre;2865;1511;1354
12053;      Frankfurt (Oder), Kreisfreie Stadt;40 bis unter 45 Jahre;3719;1911;1808
12053;      Frankfurt (Oder), Kreisfreie Stadt;45 bis unter 50 Jahre;5181;2540;2641
12053;      Frankfurt (Oder), Kreisfreie Stadt;50 bis unter 55 Jahre;5443;2675;2768
12053;      Frankfurt (Oder), Kreisfreie Stadt;55 bis unter 60 Jahre;5227;2622;2605
12053;      Frankfurt (Oder), Kreisfreie Stadt;60 bis unter 65 Jahre;4024;1976;2048
12053;      Frankfurt (Oder), Kreisfreie Stadt;65 bis unter 75 Jahre;7429;3288;4141
12053;      Frankfurt (Oder), Kreisfreie Stadt;75 Jahre und mehr;6200;2291;3909
12053;      Frankfurt (Oder), Kreisfreie Stadt;Insgesamt;60002;29133;30869
12054;      Potsdam, Kreisfreie Stadt;unter 3 Jahre;5158;2675;2483
12054;      Potsdam, Kreisfreie Stadt;3 bis unter 6 Jahre;4835;2496;2339
12054;      Potsdam, Kreisfreie Stadt;6 bis unter 10 Jahre;5669;2937;2732
12054;      Potsdam, Kreisfreie Stadt;10 bis unter 15 Jahre;5833;2878;2955
12054;      Potsdam, Kreisfreie Stadt;15 bis unter 18 Jahre;2713;1395;1318
12054;      Potsdam, Kreisfreie Stadt;18 bis unter 20 Jahre;1949;982;967
12054;      Potsdam, Kreisfreie Stadt;20 bis unter 25 Jahre;10991;5131;5860
12054;      Potsdam, Kreisfreie Stadt;25 bis unter 30 Jahre;13020;6362;6658
12054;      Potsdam, Kreisfreie Stadt;30 bis unter 35 Jahre;13023;6581;6442
12054;      Potsdam, Kreisfreie Stadt;35 bis unter 40 Jahre;10245;5270;4975
12054;      Potsdam, Kreisfreie Stadt;40 bis unter 45 Jahre;11526;6034;5492
12054;      Potsdam, Kreisfreie Stadt;45 bis unter 50 Jahre;12970;6694;6276
12054;      Potsdam, Kreisfreie Stadt;50 bis unter 55 Jahre;11256;5737;5519
12054;      Potsdam, Kreisfreie Stadt;55 bis unter 60 Jahre;10391;5072;5319
12054;      Potsdam, Kreisfreie Stadt;60 bis unter 65 Jahre;8313;4045;4268
12054;      Potsdam, Kreisfreie Stadt;65 bis unter 75 Jahre;16817;7525;9292
12054;      Potsdam, Kreisfreie Stadt;75 Jahre und mehr;14193;5260;8933
12054;      Potsdam, Kreisfreie Stadt;Insgesamt;158902;77074;81828
12060;      Barnim, Landkreis;unter 3 Jahre;4212;2154;2058
12060;      Barnim, Landkreis;3 bis unter 6 Jahre;4361;2230;2131
12060;      Barnim, Landkreis;6 bis unter 10 Jahre;5766;3028;2738
12060;      Barnim, Landkreis;10 bis unter 15 Jahre;6867;3514;3353
12060;      Barnim, Landkreis;15 bis unter 18 Jahre;3417;1774;1643
12060;      Barnim, Landkreis;18 bis unter 20 Jahre;2173;1100;1073
12060;      Barnim, Landkreis;20 bis unter 25 Jahre;9212;4836;4376
12060;      Barnim, Landkreis;25 bis unter 30 Jahre;9694;5104;4590
12060;      Barnim, Landkreis;30 bis unter 35 Jahre;10206;5159;5047
12060;      Barnim, Landkreis;35 bis unter 40 Jahre;9493;4935;4558
12060;      Barnim, Landkreis;40 bis unter 45 Jahre;13371;6829;6542
12060;      Barnim, Landkreis;45 bis unter 50 Jahre;17599;9001;8598
12060;      Barnim, Landkreis;50 bis unter 55 Jahre;16683;8569;8114
12060;      Barnim, Landkreis;55 bis unter 60 Jahre;14749;7375;7374
12060;      Barnim, Landkreis;60 bis unter 65 Jahre;11557;5835;5722
12060;      Barnim, Landkreis;65 bis unter 75 Jahre;21602;10396;11206
12060;      Barnim, Landkreis;75 Jahre und mehr;15991;6070;9921
12060;      Barnim, Landkreis;Insgesamt;176953;87909;89044
12061;      Dahme-Spreewald, Landkreis;unter 3 Jahre;3800;1909;1891
12061;      Dahme-Spreewald, Landkreis;3 bis unter 6 Jahre;3910;2051;1859
12061;      Dahme-Spreewald, Landkreis;6 bis unter 10 Jahre;5061;2551;2510
12061;      Dahme-Spreewald, Landkreis;10 bis unter 15 Jahre;6582;3300;3282
12061;      Dahme-Spreewald, Landkreis;15 bis unter 18 Jahre;3310;1713;1597
12061;      Dahme-Spreewald, Landkreis;18 bis unter 20 Jahre;2043;1045;998
12061;      Dahme-Spreewald, Landkreis;20 bis unter 25 Jahre;8012;4268;3744
12061;      Dahme-Spreewald, Landkreis;25 bis unter 30 Jahre;8634;4557;4077
12061;      Dahme-Spreewald, Landkreis;30 bis unter 35 Jahre;9241;4749;4492
12061;      Dahme-Spreewald, Landkreis;35 bis unter 40 Jahre;8489;4391;4098
12061;      Dahme-Spreewald, Landkreis;40 bis unter 45 Jahre;12501;6430;6071
12061;      Dahme-Spreewald, Landkreis;45 bis unter 50 Jahre;15691;8063;7628
12061;      Dahme-Spreewald, Landkreis;50 bis unter 55 Jahre;14644;7550;7094
12061;      Dahme-Spreewald, Landkreis;55 bis unter 60 Jahre;12867;6480;6387
12061;      Dahme-Spreewald, Landkreis;60 bis unter 65 Jahre;9838;4958;4880
12061;      Dahme-Spreewald, Landkreis;65 bis unter 75 Jahre;20567;9791;10776
12061;      Dahme-Spreewald, Landkreis;75 Jahre und mehr;16366;6347;10019
12061;      Dahme-Spreewald, Landkreis;Insgesamt;161556;80153;81403
12062;      Elbe-Elster, Landkreis;unter 3 Jahre;2100;1061;1039
12062;      Elbe-Elster, Landkreis;3 bis unter 6 Jahre;2335;1148;1187
12062;      Elbe-Elster, Landkreis;6 bis unter 10 Jahre;3140;1592;1548
12062;      Elbe-Elster, Landkreis;10 bis unter 15 Jahre;4066;2058;2008
12062;      Elbe-Elster, Landkreis;15 bis unter 18 Jahre;2045;1066;979
12062;      Elbe-Elster, Landkreis;18 bis unter 20 Jahre;1362;735;627
12062;      Elbe-Elster, Landkreis;20 bis unter 25 Jahre;5474;3057;2417
12062;      Elbe-Elster, Landkreis;25 bis unter 30 Jahre;5853;3361;2492
12062;      Elbe-Elster, Landkreis;30 bis unter 35 Jahre;5539;3055;2484
12062;      Elbe-Elster, Landkreis;35 bis unter 40 Jahre;5440;2977;2463
12062;      Elbe-Elster, Landkreis;40 bis unter 45 Jahre;8043;4244;3799
12062;      Elbe-Elster, Landkreis;45 bis unter 50 Jahre;10086;5199;4887
12062;      Elbe-Elster, Landkreis;50 bis unter 55 Jahre;10358;5326;5032
12062;      Elbe-Elster, Landkreis;55 bis unter 60 Jahre;9678;4946;4732
12062;      Elbe-Elster, Landkreis;60 bis unter 65 Jahre;7241;3551;3690
12062;      Elbe-Elster, Landkreis;65 bis unter 75 Jahre;14824;6879;7945
12062;      Elbe-Elster, Landkreis;75 Jahre und mehr;12707;4526;8181
12062;      Elbe-Elster, Landkreis;Insgesamt;110291;54781;55510
12063;      Havelland, Landkreis;unter 3 Jahre;3712;1900;1812
12063;      Havelland, Landkreis;3 bis unter 6 Jahre;3824;1967;1857
12063;      Havelland, Landkreis;6 bis unter 10 Jahre;5533;2848;2685
12063;      Havelland, Landkreis;10 bis unter 15 Jahre;7517;3873;3644
12063;      Havelland, Landkreis;15 bis unter 18 Jahre;3773;1984;1789
12063;      Havelland, Landkreis;18 bis unter 20 Jahre;2373;1250;1123
12063;      Havelland, Landkreis;20 bis unter 25 Jahre;7952;4273;3679
12063;      Havelland, Landkreis;25 bis unter 30 Jahre;7671;4010;3661
12063;      Havelland, Landkreis;30 bis unter 35 Jahre;8090;4059;4031
12063;      Havelland, Landkreis;35 bis unter 40 Jahre;8151;4022;4129
12063;      Havelland, Landkreis;40 bis unter 45 Jahre;12682;6219;6463
12063;      Havelland, Landkreis;45 bis unter 50 Jahre;16264;8369;7895
12063;      Havelland, Landkreis;50 bis unter 55 Jahre;14095;7327;6768
12063;      Havelland, Landkreis;55 bis unter 60 Jahre;11926;6072;5854
12063;      Havelland, Landkreis;60 bis unter 65 Jahre;9238;4577;4661
12063;      Havelland, Landkreis;65 bis unter 75 Jahre;18780;8884;9896
12063;      Havelland, Landkreis;75 Jahre und mehr;13645;5150;8495
12063;      Havelland, Landkreis;Insgesamt;155226;76784;78442
12064;      Märkisch-Oderland, Landkreis;unter 3 Jahre;4280;2203;2077
12064;      Märkisch-Oderland, Landkreis;3 bis unter 6 Jahre;4503;2324;2179
12064;      Märkisch-Oderland, Landkreis;6 bis unter 10 Jahre;5970;3124;2846
12064;      Märkisch-Oderland, Landkreis;10 bis unter 15 Jahre;7285;3707;3578
12064;      Märkisch-Oderland, Landkreis;15 bis unter 18 Jahre;3879;2004;1875
12064;      Märkisch-Oderland, Landkreis;18 bis unter 20 Jahre;2226;1179;1047
12064;      Märkisch-Oderland, Landkreis;20 bis unter 25 Jahre;9610;5243;4367
12064;      Märkisch-Oderland, Landkreis;25 bis unter 30 Jahre;9713;5149;4564
12064;      Märkisch-Oderland, Landkreis;30 bis unter 35 Jahre;10677;5426;5251
12064;      Märkisch-Oderland, Landkreis;35 bis unter 40 Jahre;9936;5182;4754
12064;      Märkisch-Oderland, Landkreis;40 bis unter 45 Jahre;14260;7369;6891
12064;      Märkisch-Oderland, Landkreis;45 bis unter 50 Jahre;19387;9860;9527
12064;      Märkisch-Oderland, Landkreis;50 bis unter 55 Jahre;18811;9741;9070
12064;      Märkisch-Oderland, Landkreis;55 bis unter 60 Jahre;16246;8381;7865
12064;      Märkisch-Oderland, Landkreis;60 bis unter 65 Jahre;12161;6133;6028
12064;      Märkisch-Oderland, Landkreis;65 bis unter 75 Jahre;22301;10575;11726
12064;      Märkisch-Oderland, Landkreis;75 Jahre und mehr;18428;7098;11330
12064;      Märkisch-Oderland, Landkreis;Insgesamt;189673;94698;94975
12065;      Oberhavel, Landkreis;unter 3 Jahre;4956;2545;2411
12065;      Oberhavel, Landkreis;3 bis unter 6 Jahre;5163;2669;2494
12065;      Oberhavel, Landkreis;6 bis unter 10 Jahre;7360;3801;3559
12065;      Oberhavel, Landkreis;10 bis unter 15 Jahre;8939;4542;4397
12065;      Oberhavel, Landkreis;15 bis unter 18 Jahre;4688;2478;2210
12065;      Oberhavel, Landkreis;18 bis unter 20 Jahre;2739;1398;1341
12065;      Oberhavel, Landkreis;20 bis unter 25 Jahre;9906;5241;4665
12065;      Oberhavel, Landkreis;25 bis unter 30 Jahre;10605;5522;5083
12065;      Oberhavel, Landkreis;30 bis unter 35 Jahre;11557;5752;5805
12065;      Oberhavel, Landkreis;35 bis unter 40 Jahre;10865;5402;5463
12065;      Oberhavel, Landkreis;40 bis unter 45 Jahre;16504;8186;8318
12065;      Oberhavel, Landkreis;45 bis unter 50 Jahre;20938;10814;10124
12065;      Oberhavel, Landkreis;50 bis unter 55 Jahre;18373;9487;8886
12065;      Oberhavel, Landkreis;55 bis unter 60 Jahre;15825;8029;7796
12065;      Oberhavel, Landkreis;60 bis unter 65 Jahre;12237;6114;6123
12065;      Oberhavel, Landkreis;65 bis unter 75 Jahre;24486;11608;12878
12065;      Oberhavel, Landkreis;75 Jahre und mehr;18367;7113;11254
12065;      Oberhavel, Landkreis;Insgesamt;203508;100701;102807
12066;      Oberspreewald-Lausitz, Landkreis;unter 3 Jahre;2456;1240;1216
12066;      Oberspreewald-Lausitz, Landkreis;3 bis unter 6 Jahre;2352;1203;1149
12066;      Oberspreewald-Lausitz, Landkreis;6 bis unter 10 Jahre;3224;1664;1560
12066;      Oberspreewald-Lausitz, Landkreis;10 bis unter 15 Jahre;4102;2101;2001
12066;      Oberspreewald-Lausitz, Landkreis;15 bis unter 18 Jahre;2129;1143;986
12066;      Oberspreewald-Lausitz, Landkreis;18 bis unter 20 Jahre;1403;741;662
12066;      Oberspreewald-Lausitz, Landkreis;20 bis unter 25 Jahre;6182;3260;2922
12066;      Oberspreewald-Lausitz, Landkreis;25 bis unter 30 Jahre;6567;3644;2923
12066;      Oberspreewald-Lausitz, Landkreis;30 bis unter 35 Jahre;6272;3522;2750
12066;      Oberspreewald-Lausitz, Landkreis;35 bis unter 40 Jahre;5658;3069;2589
12066;      Oberspreewald-Lausitz, Landkreis;40 bis unter 45 Jahre;8694;4692;4002
12066;      Oberspreewald-Lausitz, Landkreis;45 bis unter 50 Jahre;10949;5739;5210
12066;      Oberspreewald-Lausitz, Landkreis;50 bis unter 55 Jahre;10737;5512;5225
12066;      Oberspreewald-Lausitz, Landkreis;55 bis unter 60 Jahre;9978;4993;4985
12066;      Oberspreewald-Lausitz, Landkreis;60 bis unter 65 Jahre;8059;3979;4080
12066;      Oberspreewald-Lausitz, Landkreis;65 bis unter 75 Jahre;17304;7747;9557
12066;      Oberspreewald-Lausitz, Landkreis;75 Jahre und mehr;13957;4992;8965
12066;      Oberspreewald-Lausitz, Landkreis;Insgesamt;120023;59241;60782
12067;      Oder-Spree, Landkreis;unter 3 Jahre;4035;2075;1960
12067;      Oder-Spree, Landkreis;3 bis unter 6 Jahre;4114;2038;2076
12067;      Oder-Spree, Landkreis;6 bis unter 10 Jahre;5423;2751;2672
12067;      Oder-Spree, Landkreis;10 bis unter 15 Jahre;6888;3576;3312
12067;      Oder-Spree, Landkreis;15 bis unter 18 Jahre;3582;1892;1690
12067;      Oder-Spree, Landkreis;18 bis unter 20 Jahre;2217;1209;1008
12067;      Oder-Spree, Landkreis;20 bis unter 25 Jahre;9281;5035;4246
12067;      Oder-Spree, Landkreis;25 bis unter 30 Jahre;9786;5255;4531
12067;      Oder-Spree, Landkreis;30 bis unter 35 Jahre;10084;5415;4669
12067;      Oder-Spree, Landkreis;35 bis unter 40 Jahre;9352;4962;4390
12067;      Oder-Spree, Landkreis;40 bis unter 45 Jahre;13385;7011;6374
12067;      Oder-Spree, Landkreis;45 bis unter 50 Jahre;17381;8900;8481
12067;      Oder-Spree, Landkreis;50 bis unter 55 Jahre;16866;8595;8271
12067;      Oder-Spree, Landkreis;55 bis unter 60 Jahre;15827;7998;7829
12067;      Oder-Spree, Landkreis;60 bis unter 65 Jahre;11865;5876;5989
12067;      Oder-Spree, Landkreis;65 bis unter 75 Jahre;23779;11135;12644
12067;      Oder-Spree, Landkreis;75 Jahre und mehr;18933;7254;11679
12067;      Oder-Spree, Landkreis;Insgesamt;182798;90977;91821
12068;      Ostprignitz-Ruppin, Landkreis;unter 3 Jahre;2226;1189;1037
12068;      Ostprignitz-Ruppin, Landkreis;3 bis unter 6 Jahre;2314;1206;1108
12068;      Ostprignitz-Ruppin, Landkreis;6 bis unter 10 Jahre;2947;1497;1450
12068;      Ostprignitz-Ruppin, Landkreis;10 bis unter 15 Jahre;3879;1993;1886
12068;      Ostprignitz-Ruppin, Landkreis;15 bis unter 18 Jahre;1964;969;995
12068;      Ostprignitz-Ruppin, Landkreis;18 bis unter 20 Jahre;1317;685;632
12068;      Ostprignitz-Ruppin, Landkreis;20 bis unter 25 Jahre;5437;2992;2445
12068;      Ostprignitz-Ruppin, Landkreis;25 bis unter 30 Jahre;5869;3179;2690
12068;      Ostprignitz-Ruppin, Landkreis;30 bis unter 35 Jahre;5678;3054;2624
12068;      Ostprignitz-Ruppin, Landkreis;35 bis unter 40 Jahre;5035;2711;2324
12068;      Ostprignitz-Ruppin, Landkreis;40 bis unter 45 Jahre;7273;3857;3416
12068;      Ostprignitz-Ruppin, Landkreis;45 bis unter 50 Jahre;9711;5061;4650
12068;      Ostprignitz-Ruppin, Landkreis;50 bis unter 55 Jahre;10011;5149;4862
12068;      Ostprignitz-Ruppin, Landkreis;55 bis unter 60 Jahre;9056;4596;4460
12068;      Ostprignitz-Ruppin, Landkreis;60 bis unter 65 Jahre;6590;3325;3265
12068;      Ostprignitz-Ruppin, Landkreis;65 bis unter 75 Jahre;12292;5822;6470
12068;      Ostprignitz-Ruppin, Landkreis;75 Jahre und mehr;10509;3805;6704
12068;      Ostprignitz-Ruppin, Landkreis;Insgesamt;102108;51090;51018
12069;      Potsdam-Mittelmark, Landkreis;unter 3 Jahre;4823;2454;2369
12069;      Potsdam-Mittelmark, Landkreis;3 bis unter 6 Jahre;5492;2850;2642
12069;      Potsdam-Mittelmark, Landkreis;6 bis unter 10 Jahre;7590;3847;3743
12069;      Potsdam-Mittelmark, Landkreis;10 bis unter 15 Jahre;9753;4965;4788
12069;      Potsdam-Mittelmark, Landkreis;15 bis unter 18 Jahre;4746;2416;2330
12069;      Potsdam-Mittelmark, Landkreis;18 bis unter 20 Jahre;2732;1413;1319
12069;      Potsdam-Mittelmark, Landkreis;20 bis unter 25 Jahre;9689;5226;4463
12069;      Potsdam-Mittelmark, Landkreis;25 bis unter 30 Jahre;9650;5136;4514
12069;      Potsdam-Mittelmark, Landkreis;30 bis unter 35 Jahre;10962;5456;5506
12069;      Potsdam-Mittelmark, Landkreis;35 bis unter 40 Jahre;11277;5673;5604
12069;      Potsdam-Mittelmark, Landkreis;40 bis unter 45 Jahre;16820;8339;8481
12069;      Potsdam-Mittelmark, Landkreis;45 bis unter 50 Jahre;21571;10958;10613
12069;      Potsdam-Mittelmark, Landkreis;50 bis unter 55 Jahre;19341;9983;9358
12069;      Potsdam-Mittelmark, Landkreis;55 bis unter 60 Jahre;16759;8627;8132
12069;      Potsdam-Mittelmark, Landkreis;60 bis unter 65 Jahre;12400;6244;6156
12069;      Potsdam-Mittelmark, Landkreis;65 bis unter 75 Jahre;23617;11332;12285
12069;      Potsdam-Mittelmark, Landkreis;75 Jahre und mehr;18456;7093;11363
12069;      Potsdam-Mittelmark, Landkreis;Insgesamt;205678;102012;103666
12070;      Prignitz, Landkreis;unter 3 Jahre;1549;813;736
12070;      Prignitz, Landkreis;3 bis unter 6 Jahre;1592;806;786
12070;      Prignitz, Landkreis;6 bis unter 10 Jahre;2177;1151;1026
12070;      Prignitz, Landkreis;10 bis unter 15 Jahre;2917;1513;1404
12070;      Prignitz, Landkreis;15 bis unter 18 Jahre;1610;827;783
12070;      Prignitz, Landkreis;18 bis unter 20 Jahre;1034;536;498
12070;      Prignitz, Landkreis;20 bis unter 25 Jahre;4298;2383;1915
12070;      Prignitz, Landkreis;25 bis unter 30 Jahre;4241;2385;1856
12070;      Prignitz, Landkreis;30 bis unter 35 Jahre;3880;2108;1772
12070;      Prignitz, Landkreis;35 bis unter 40 Jahre;3432;1834;1598
12070;      Prignitz, Landkreis;40 bis unter 45 Jahre;5323;2704;2619
12070;      Prignitz, Landkreis;45 bis unter 50 Jahre;7730;3977;3753
12070;      Prignitz, Landkreis;50 bis unter 55 Jahre;7833;3995;3838
12070;      Prignitz, Landkreis;55 bis unter 60 Jahre;7069;3606;3463
12070;      Prignitz, Landkreis;60 bis unter 65 Jahre;5578;2768;2810
12070;      Prignitz, Landkreis;65 bis unter 75 Jahre;10931;4979;5952
12070;      Prignitz, Landkreis;75 Jahre und mehr;9678;3522;6156
12070;      Prignitz, Landkreis;Insgesamt;80872;39907;40965
12071;      Spree-Neiße, Landkreis;unter 3 Jahre;2376;1223;1153
12071;      Spree-Neiße, Landkreis;3 bis unter 6 Jahre;2572;1331;1241
12071;      Spree-Neiße, Landkreis;6 bis unter 10 Jahre;3347;1766;1581
12071;      Spree-Neiße, Landkreis;10 bis unter 15 Jahre;4557;2370;2187
12071;      Spree-Neiße, Landkreis;15 bis unter 18 Jahre;2277;1159;1118
12071;      Spree-Neiße, Landkreis;18 bis unter 20 Jahre;1416;712;704
12071;      Spree-Neiße, Landkreis;20 bis unter 25 Jahre;6073;3381;2692
12071;      Spree-Neiße, Landkreis;25 bis unter 30 Jahre;6404;3656;2748
12071;      Spree-Neiße, Landkreis;30 bis unter 35 Jahre;6297;3505;2792
12071;      Spree-Neiße, Landkreis;35 bis unter 40 Jahre;5700;2996;2704
12071;      Spree-Neiße, Landkreis;40 bis unter 45 Jahre;9087;4743;4344
12071;      Spree-Neiße, Landkreis;45 bis unter 50 Jahre;12190;6287;5903
12071;      Spree-Neiße, Landkreis;50 bis unter 55 Jahre;12354;6399;5955
12071;      Spree-Neiße, Landkreis;55 bis unter 60 Jahre;11607;5997;5610
12071;      Spree-Neiße, Landkreis;60 bis unter 65 Jahre;8528;4264;4264
12071;      Spree-Neiße, Landkreis;65 bis unter 75 Jahre;16246;7548;8698
12071;      Spree-Neiße, Landkreis;75 Jahre und mehr;13631;5019;8612
12071;      Spree-Neiße, Landkreis;Insgesamt;124662;62356;62306
12072;      Teltow-Fläming, Landkreis;unter 3 Jahre;3833;1966;1867
12072;      Teltow-Fläming, Landkreis;3 bis unter 6 Jahre;4010;2043;1967
12072;      Teltow-Fläming, Landkreis;6 bis unter 10 Jahre;5493;2854;2639
12072;      Teltow-Fläming, Landkreis;10 bis unter 15 Jahre;6805;3501;3304
12072;      Teltow-Fläming, Landkreis;15 bis unter 18 Jahre;3619;1864;1755
12072;      Teltow-Fläming, Landkreis;18 bis unter 20 Jahre;2119;1119;1000
12072;      Teltow-Fläming, Landkreis;20 bis unter 25 Jahre;8726;4611;4115
12072;      Teltow-Fläming, Landkreis;25 bis unter 30 Jahre;9208;4904;4304
12072;      Teltow-Fläming, Landkreis;30 bis unter 35 Jahre;9298;4854;4444
12072;      Teltow-Fläming, Landkreis;35 bis unter 40 Jahre;8582;4412;4170
12072;      Teltow-Fläming, Landkreis;40 bis unter 45 Jahre;12888;6656;6232
12072;      Teltow-Fläming, Landkreis;45 bis unter 50 Jahre;16327;8514;7813
12072;      Teltow-Fläming, Landkreis;50 bis unter 55 Jahre;14559;7532;7027
12072;      Teltow-Fläming, Landkreis;55 bis unter 60 Jahre;12429;6355;6074
12072;      Teltow-Fläming, Landkreis;60 bis unter 65 Jahre;9567;4836;4731
12072;      Teltow-Fläming, Landkreis;65 bis unter 75 Jahre;19263;9044;10219
12072;      Teltow-Fläming, Landkreis;75 Jahre und mehr;14820;5518;9302
12072;      Teltow-Fläming, Landkreis;Insgesamt;161546;80583;80963
12073;      Uckermark, Landkreis;unter 3 Jahre;2606;1372;1234
12073;      Uckermark, Landkreis;3 bis unter 6 Jahre;2766;1444;1322
12073;      Uckermark, Landkreis;6 bis unter 10 Jahre;3661;1831;1830
12073;      Uckermark, Landkreis;10 bis unter 15 Jahre;4880;2512;2368
12073;      Uckermark, Landkreis;15 bis unter 18 Jahre;2596;1298;1298
12073;      Uckermark, Landkreis;18 bis unter 20 Jahre;1665;896;769
12073;      Uckermark, Landkreis;20 bis unter 25 Jahre;6474;3576;2898
12073;      Uckermark, Landkreis;25 bis unter 30 Jahre;6565;3633;2932
12073;      Uckermark, Landkreis;30 bis unter 35 Jahre;6498;3504;2994
12073;      Uckermark, Landkreis;35 bis unter 40 Jahre;6037;3141;2896
12073;      Uckermark, Landkreis;40 bis unter 45 Jahre;8976;4720;4256
12073;      Uckermark, Landkreis;45 bis unter 50 Jahre;12175;6329;5846
12073;      Uckermark, Landkreis;50 bis unter 55 Jahre;12488;6435;6053
12073;      Uckermark, Landkreis;55 bis unter 60 Jahre;11453;5827;5626
12073;      Uckermark, Landkreis;60 bis unter 65 Jahre;9055;4522;4533
12073;      Uckermark, Landkreis;65 bis unter 75 Jahre;16759;7765;8994
12073;      Uckermark, Landkreis;75 Jahre und mehr;13520;5078;8442
12073;      Uckermark, Landkreis;Insgesamt;128174;63883;64291
13;  Mecklenburg-Vorpommern;unter 3 Jahre;39223;19943;19280
13;  Mecklenburg-Vorpommern;3 bis unter 6 Jahre;38644;19735;18909
13;  Mecklenburg-Vorpommern;6 bis unter 10 Jahre;49923;25483;24440
13;  Mecklenburg-Vorpommern;10 bis unter 15 Jahre;61272;31419;29853
13;  Mecklenburg-Vorpommern;15 bis unter 18 Jahre;30438;15708;14730
13;  Mecklenburg-Vorpommern;18 bis unter 20 Jahre;20941;10895;10046
13;  Mecklenburg-Vorpommern;20 bis unter 25 Jahre;99420;52340;47080
13;  Mecklenburg-Vorpommern;25 bis unter 30 Jahre;102554;54815;47739
13;  Mecklenburg-Vorpommern;30 bis unter 35 Jahre;97201;52093;45108
13;  Mecklenburg-Vorpommern;35 bis unter 40 Jahre;80394;42798;37596
13;  Mecklenburg-Vorpommern;40 bis unter 45 Jahre;112415;58409;54006
13;  Mecklenburg-Vorpommern;45 bis unter 50 Jahre;148707;76763;71944
13;  Mecklenburg-Vorpommern;50 bis unter 55 Jahre;149872;76755;73117
13;  Mecklenburg-Vorpommern;55 bis unter 60 Jahre;138933;70013;68920
13;  Mecklenburg-Vorpommern;60 bis unter 65 Jahre;105739;52531;53208
13;  Mecklenburg-Vorpommern;65 bis unter 75 Jahre;194955;89994;104961
13;  Mecklenburg-Vorpommern;75 Jahre und mehr;164103;59509;104594
13;  Mecklenburg-Vorpommern;Insgesamt;1634734;809203;825531
13003;      Rostock, Hansestadt;unter 3 Jahre;5314;2737;2577
13003;      Rostock, Hansestadt;3 bis unter 6 Jahre;4723;2422;2301
13003;      Rostock, Hansestadt;6 bis unter 10 Jahre;5554;2849;2705
13003;      Rostock, Hansestadt;10 bis unter 15 Jahre;6159;3146;3013
13003;      Rostock, Hansestadt;15 bis unter 18 Jahre;2928;1507;1421
13003;      Rostock, Hansestadt;18 bis unter 20 Jahre;2823;1352;1471
13003;      Rostock, Hansestadt;20 bis unter 25 Jahre;18698;9217;9481
13003;      Rostock, Hansestadt;25 bis unter 30 Jahre;18355;9863;8492
13003;      Rostock, Hansestadt;30 bis unter 35 Jahre;14378;7901;6477
13003;      Rostock, Hansestadt;35 bis unter 40 Jahre;9829;5358;4471
13003;      Rostock, Hansestadt;40 bis unter 45 Jahre;12521;6646;5875
13003;      Rostock, Hansestadt;45 bis unter 50 Jahre;15531;8064;7467
13003;      Rostock, Hansestadt;50 bis unter 55 Jahre;14872;7566;7306
13003;      Rostock, Hansestadt;55 bis unter 60 Jahre;14291;7058;7233
13003;      Rostock, Hansestadt;60 bis unter 65 Jahre;11697;5521;6176
13003;      Rostock, Hansestadt;65 bis unter 75 Jahre;26093;11591;14502
13003;      Rostock, Hansestadt;75 Jahre und mehr;20494;7680;12814
13003;      Rostock, Hansestadt;Insgesamt;204260;100478;103782
13004;      Schwerin, Landeshauptstadt;unter 3 Jahre;2380;1218;1162
13004;      Schwerin, Landeshauptstadt;3 bis unter 6 Jahre;2257;1180;1077
13004;      Schwerin, Landeshauptstadt;6 bis unter 10 Jahre;2892;1467;1425
13004;      Schwerin, Landeshauptstadt;10 bis unter 15 Jahre;3130;1592;1538
13004;      Schwerin, Landeshauptstadt;15 bis unter 18 Jahre;1560;816;744
13004;      Schwerin, Landeshauptstadt;18 bis unter 20 Jahre;1322;622;700
13004;      Schwerin, Landeshauptstadt;20 bis unter 25 Jahre;6206;3032;3174
13004;      Schwerin, Landeshauptstadt;25 bis unter 30 Jahre;6490;3355;3135
13004;      Schwerin, Landeshauptstadt;30 bis unter 35 Jahre;6262;3354;2908
13004;      Schwerin, Landeshauptstadt;35 bis unter 40 Jahre;4819;2614;2205
13004;      Schwerin, Landeshauptstadt;40 bis unter 45 Jahre;6271;3295;2976
13004;      Schwerin, Landeshauptstadt;45 bis unter 50 Jahre;7842;3953;3889
13004;      Schwerin, Landeshauptstadt;50 bis unter 55 Jahre;7441;3605;3836
13004;      Schwerin, Landeshauptstadt;55 bis unter 60 Jahre;7597;3638;3959
13004;      Schwerin, Landeshauptstadt;60 bis unter 65 Jahre;6192;2968;3224
13004;      Schwerin, Landeshauptstadt;65 bis unter 75 Jahre;12203;5451;6752
13004;      Schwerin, Landeshauptstadt;75 Jahre und mehr;10436;3653;6783
13004;      Schwerin, Landeshauptstadt;Insgesamt;95300;45813;49487
13071;      Mecklenburgische Seenplatte;unter 3 Jahre;6306;3181;3125
13071;      Mecklenburgische Seenplatte;3 bis unter 6 Jahre;6452;3304;3148
13071;      Mecklenburgische Seenplatte;6 bis unter 10 Jahre;8167;4190;3977
13071;      Mecklenburgische Seenplatte;10 bis unter 15 Jahre;10373;5337;5036
13071;      Mecklenburgische Seenplatte;15 bis unter 18 Jahre;5051;2578;2473
13071;      Mecklenburgische Seenplatte;18 bis unter 20 Jahre;3417;1812;1605
13071;      Mecklenburgische Seenplatte;20 bis unter 25 Jahre;14897;8051;6846
13071;      Mecklenburgische Seenplatte;25 bis unter 30 Jahre;15509;8329;7180
13071;      Mecklenburgische Seenplatte;30 bis unter 35 Jahre;15362;8283;7079
13071;      Mecklenburgische Seenplatte;35 bis unter 40 Jahre;13167;7025;6142
13071;      Mecklenburgische Seenplatte;40 bis unter 45 Jahre;18133;9382;8751
13071;      Mecklenburgische Seenplatte;45 bis unter 50 Jahre;25085;12911;12174
13071;      Mecklenburgische Seenplatte;50 bis unter 55 Jahre;26328;13474;12854
13071;      Mecklenburgische Seenplatte;55 bis unter 60 Jahre;24286;12088;12198
13071;      Mecklenburgische Seenplatte;60 bis unter 65 Jahre;18155;8993;9162
13071;      Mecklenburgische Seenplatte;65 bis unter 75 Jahre;32099;14707;17392
13071;      Mecklenburgische Seenplatte;75 Jahre und mehr;27898;9947;17951
13071;      Mecklenburgische Seenplatte;Insgesamt;270685;133592;137093
13072;      Rostock;unter 3 Jahre;5187;2618;2569
13072;      Rostock;3 bis unter 6 Jahre;5358;2728;2630
13072;      Rostock;6 bis unter 10 Jahre;7168;3676;3492
13072;      Rostock;10 bis unter 15 Jahre;8798;4508;4290
13072;      Rostock;15 bis unter 18 Jahre;4402;2274;2128
13072;      Rostock;18 bis unter 20 Jahre;2629;1392;1237
13072;      Rostock;20 bis unter 25 Jahre;10642;5848;4794
13072;      Rostock;25 bis unter 30 Jahre;11377;6109;5268
13072;      Rostock;30 bis unter 35 Jahre;12104;6340;5764
13072;      Rostock;35 bis unter 40 Jahre;10755;5728;5027
13072;      Rostock;40 bis unter 45 Jahre;15985;8229;7756
13072;      Rostock;45 bis unter 50 Jahre;21341;11014;10327
13072;      Rostock;50 bis unter 55 Jahre;21238;10960;10278
13072;      Rostock;55 bis unter 60 Jahre;19038;9735;9303
13072;      Rostock;60 bis unter 65 Jahre;14191;7178;7013
13072;      Rostock;65 bis unter 75 Jahre;24807;11798;13009
13072;      Rostock;75 Jahre und mehr;19869;7314;12555
13072;      Rostock;Insgesamt;214889;107449;107440
13073;      Vorpommern-Rügen;unter 3 Jahre;5313;2687;2626
13073;      Vorpommern-Rügen;3 bis unter 6 Jahre;5277;2673;2604
13073;      Vorpommern-Rügen;6 bis unter 10 Jahre;6604;3353;3251
13073;      Vorpommern-Rügen;10 bis unter 15 Jahre;8329;4298;4031
13073;      Vorpommern-Rügen;15 bis unter 18 Jahre;4235;2189;2046
13073;      Vorpommern-Rügen;18 bis unter 20 Jahre;2768;1464;1304
13073;      Vorpommern-Rügen;20 bis unter 25 Jahre;12709;6738;5971
13073;      Vorpommern-Rügen;25 bis unter 30 Jahre;13300;7094;6206
13073;      Vorpommern-Rügen;30 bis unter 35 Jahre;13014;6902;6112
13073;      Vorpommern-Rügen;35 bis unter 40 Jahre;10729;5542;5187
13073;      Vorpommern-Rügen;40 bis unter 45 Jahre;15621;8027;7594
13073;      Vorpommern-Rügen;45 bis unter 50 Jahre;21430;11075;10355
13073;      Vorpommern-Rügen;50 bis unter 55 Jahre;21599;11115;10484
13073;      Vorpommern-Rügen;55 bis unter 60 Jahre;19931;10036;9895
13073;      Vorpommern-Rügen;60 bis unter 65 Jahre;15004;7414;7590
13073;      Vorpommern-Rügen;65 bis unter 75 Jahre;29421;13526;15895
13073;      Vorpommern-Rügen;75 Jahre und mehr;24056;8880;15176
13073;      Vorpommern-Rügen;Insgesamt;229340;113013;116327
13074;      Nordwestmecklenburg;unter 3 Jahre;3973;2051;1922
13074;      Nordwestmecklenburg;3 bis unter 6 Jahre;3919;1997;1922
13074;      Nordwestmecklenburg;6 bis unter 10 Jahre;5307;2708;2599
13074;      Nordwestmecklenburg;10 bis unter 15 Jahre;6570;3360;3210
13074;      Nordwestmecklenburg;15 bis unter 18 Jahre;3317;1748;1569
13074;      Nordwestmecklenburg;18 bis unter 20 Jahre;1984;1054;930
13074;      Nordwestmecklenburg;20 bis unter 25 Jahre;8873;4828;4045
13074;      Nordwestmecklenburg;25 bis unter 30 Jahre;9636;5050;4586
13074;      Nordwestmecklenburg;30 bis unter 35 Jahre;9754;5188;4566
13074;      Nordwestmecklenburg;35 bis unter 40 Jahre;8512;4503;4009
13074;      Nordwestmecklenburg;40 bis unter 45 Jahre;11876;6198;5678
13074;      Nordwestmecklenburg;45 bis unter 50 Jahre;14835;7740;7095
13074;      Nordwestmecklenburg;50 bis unter 55 Jahre;14529;7482;7047
13074;      Nordwestmecklenburg;55 bis unter 60 Jahre;13107;6748;6359
13074;      Nordwestmecklenburg;60 bis unter 65 Jahre;10225;5097;5128
13074;      Nordwestmecklenburg;65 bis unter 75 Jahre;17789;8366;9423
13074;      Nordwestmecklenburg;75 Jahre und mehr;15088;5484;9604
13074;      Nordwestmecklenburg;Insgesamt;159294;79602;79692
13075;      Vorpommern-Greifswald;unter 3 Jahre;5720;2899;2821
13075;      Vorpommern-Greifswald;3 bis unter 6 Jahre;5656;2903;2753
13075;      Vorpommern-Greifswald;6 bis unter 10 Jahre;7280;3752;3528
13075;      Vorpommern-Greifswald;10 bis unter 15 Jahre;8983;4566;4417
13075;      Vorpommern-Greifswald;15 bis unter 18 Jahre;4380;2239;2141
13075;      Vorpommern-Greifswald;18 bis unter 20 Jahre;3284;1735;1549
13075;      Vorpommern-Greifswald;20 bis unter 25 Jahre;15975;8143;7832
13075;      Vorpommern-Greifswald;25 bis unter 30 Jahre;16048;8456;7592
13075;      Vorpommern-Greifswald;30 bis unter 35 Jahre;14173;7585;6588
13075;      Vorpommern-Greifswald;35 bis unter 40 Jahre;11603;6147;5456
13075;      Vorpommern-Greifswald;40 bis unter 45 Jahre;16013;8403;7610
13075;      Vorpommern-Greifswald;45 bis unter 50 Jahre;21414;10995;10419
13075;      Vorpommern-Greifswald;50 bis unter 55 Jahre;22839;11711;11128
13075;      Vorpommern-Greifswald;55 bis unter 60 Jahre;21103;10713;10390
13075;      Vorpommern-Greifswald;60 bis unter 65 Jahre;15952;8033;7919
13075;      Vorpommern-Greifswald;65 bis unter 75 Jahre;28281;13137;15144
13075;      Vorpommern-Greifswald;75 Jahre und mehr;25503;9262;16241
13075;      Vorpommern-Greifswald;Insgesamt;244207;120679;123528
13076;      Ludwigslust-Parchim;unter 3 Jahre;5030;2552;2478
13076;      Ludwigslust-Parchim;3 bis unter 6 Jahre;5002;2528;2474
13076;      Ludwigslust-Parchim;6 bis unter 10 Jahre;6951;3488;3463
13076;      Ludwigslust-Parchim;10 bis unter 15 Jahre;8930;4612;4318
13076;      Ludwigslust-Parchim;15 bis unter 18 Jahre;4565;2357;2208
13076;      Ludwigslust-Parchim;18 bis unter 20 Jahre;2714;1464;1250
13076;      Ludwigslust-Parchim;20 bis unter 25 Jahre;11420;6483;4937
13076;      Ludwigslust-Parchim;25 bis unter 30 Jahre;11839;6559;5280
13076;      Ludwigslust-Parchim;30 bis unter 35 Jahre;12154;6540;5614
13076;      Ludwigslust-Parchim;35 bis unter 40 Jahre;10980;5881;5099
13076;      Ludwigslust-Parchim;40 bis unter 45 Jahre;15995;8229;7766
13076;      Ludwigslust-Parchim;45 bis unter 50 Jahre;21229;11011;10218
13076;      Ludwigslust-Parchim;50 bis unter 55 Jahre;21026;10842;10184
13076;      Ludwigslust-Parchim;55 bis unter 60 Jahre;19580;9997;9583
13076;      Ludwigslust-Parchim;60 bis unter 65 Jahre;14323;7327;6996
13076;      Ludwigslust-Parchim;65 bis unter 75 Jahre;24262;11418;12844
13076;      Ludwigslust-Parchim;75 Jahre und mehr;20759;7289;13470
13076;      Ludwigslust-Parchim;Insgesamt;216759;108577;108182
14;  Freistaat Sachsen;unter 3 Jahre;103916;53408;50508
14;  Freistaat Sachsen;3 bis unter 6 Jahre;100807;51765;49042
14;  Freistaat Sachsen;6 bis unter 10 Jahre;128214;65345;62869
14;  Freistaat Sachsen;10 bis unter 15 Jahre;151096;77467;73629
14;  Freistaat Sachsen;15 bis unter 18 Jahre;73142;37481;35661
14;  Freistaat Sachsen;18 bis unter 20 Jahre;50671;26025;24646
14;  Freistaat Sachsen;20 bis unter 25 Jahre;243850;127188;116662
14;  Freistaat Sachsen;25 bis unter 30 Jahre;267403;141344;126059
14;  Freistaat Sachsen;30 bis unter 35 Jahre;257883;137900;119983
14;  Freistaat Sachsen;35 bis unter 40 Jahre;217701;116197;101504
14;  Freistaat Sachsen;40 bis unter 45 Jahre;285241;150086;135155
14;  Freistaat Sachsen;45 bis unter 50 Jahre;336790;173747;163043
14;  Freistaat Sachsen;50 bis unter 55 Jahre;320153;162201;157952
14;  Freistaat Sachsen;55 bis unter 60 Jahre;314334;156385;157949
14;  Freistaat Sachsen;60 bis unter 65 Jahre;271600;132046;139554
14;  Freistaat Sachsen;65 bis unter 75 Jahre;539408;248553;290855
14;  Freistaat Sachsen;75 Jahre und mehr;474842;170888;303954
14;  Freistaat Sachsen;Insgesamt;4137051;2028026;2109025
141;    Chemnitz, Regierungsbezirk;unter 3 Jahre;-;-;-
141;    Chemnitz, Regierungsbezirk;3 bis unter 6 Jahre;-;-;-
141;    Chemnitz, Regierungsbezirk;6 bis unter 10 Jahre;-;-;-
141;    Chemnitz, Regierungsbezirk;10 bis unter 15 Jahre;-;-;-
141;    Chemnitz, Regierungsbezirk;15 bis unter 18 Jahre;-;-;-
141;    Chemnitz, Regierungsbezirk;18 bis unter 20 Jahre;-;-;-
141;    Chemnitz, Regierungsbezirk;20 bis unter 25 Jahre;-;-;-
141;    Chemnitz, Regierungsbezirk;25 bis unter 30 Jahre;-;-;-
141;    Chemnitz, Regierungsbezirk;30 bis unter 35 Jahre;-;-;-
141;    Chemnitz, Regierungsbezirk;35 bis unter 40 Jahre;-;-;-
141;    Chemnitz, Regierungsbezirk;40 bis unter 45 Jahre;-;-;-
141;    Chemnitz, Regierungsbezirk;45 bis unter 50 Jahre;-;-;-
141;    Chemnitz, Regierungsbezirk;50 bis unter 55 Jahre;-;-;-
141;    Chemnitz, Regierungsbezirk;55 bis unter 60 Jahre;-;-;-
141;    Chemnitz, Regierungsbezirk;60 bis unter 65 Jahre;-;-;-
141;    Chemnitz, Regierungsbezirk;65 bis unter 75 Jahre;-;-;-
141;    Chemnitz, Regierungsbezirk;75 Jahre und mehr;-;-;-
141;    Chemnitz, Regierungsbezirk;Insgesamt;-;-;-
145;    Chemnitz, Direktionsbezirk;unter 3 Jahre;34515;17714;16801
145;    Chemnitz, Direktionsbezirk;3 bis unter 6 Jahre;34422;17803;16619
145;    Chemnitz, Direktionsbezirk;6 bis unter 10 Jahre;45270;22983;22287
145;    Chemnitz, Direktionsbezirk;10 bis unter 15 Jahre;55198;28249;26949
145;    Chemnitz, Direktionsbezirk;15 bis unter 18 Jahre;27472;14234;13238
145;    Chemnitz, Direktionsbezirk;18 bis unter 20 Jahre;17983;9329;8654
145;    Chemnitz, Direktionsbezirk;20 bis unter 25 Jahre;79576;42685;36891
145;    Chemnitz, Direktionsbezirk;25 bis unter 30 Jahre;86208;46426;39782
145;    Chemnitz, Direktionsbezirk;30 bis unter 35 Jahre;84957;45993;38964
145;    Chemnitz, Direktionsbezirk;35 bis unter 40 Jahre;75059;40124;34935
145;    Chemnitz, Direktionsbezirk;40 bis unter 45 Jahre;101508;52768;48740
145;    Chemnitz, Direktionsbezirk;45 bis unter 50 Jahre;121364;61927;59437
145;    Chemnitz, Direktionsbezirk;50 bis unter 55 Jahre;119554;59957;59597
145;    Chemnitz, Direktionsbezirk;55 bis unter 60 Jahre;123958;61061;62897
145;    Chemnitz, Direktionsbezirk;60 bis unter 65 Jahre;112098;54647;57451
145;    Chemnitz, Direktionsbezirk;65 bis unter 75 Jahre;205334;94750;110584
145;    Chemnitz, Direktionsbezirk;75 Jahre und mehr;187257;66454;120803
145;    Chemnitz, Direktionsbezirk;Insgesamt;1511733;737104;774629
14511;      Chemnitz, Stadt;unter 3 Jahre;5927;3049;2878
14511;      Chemnitz, Stadt;3 bis unter 6 Jahre;5548;2844;2704
14511;      Chemnitz, Stadt;6 bis unter 10 Jahre;6883;3501;3382
14511;      Chemnitz, Stadt;10 bis unter 15 Jahre;7947;4009;3938
14511;      Chemnitz, Stadt;15 bis unter 18 Jahre;3772;1997;1775
14511;      Chemnitz, Stadt;18 bis unter 20 Jahre;2866;1440;1426
14511;      Chemnitz, Stadt;20 bis unter 25 Jahre;15132;7681;7451
14511;      Chemnitz, Stadt;25 bis unter 30 Jahre;16639;8755;7884
14511;      Chemnitz, Stadt;30 bis unter 35 Jahre;15209;8270;6939
14511;      Chemnitz, Stadt;35 bis unter 40 Jahre;11555;6073;5482
14511;      Chemnitz, Stadt;40 bis unter 45 Jahre;15382;8144;7238
14511;      Chemnitz, Stadt;45 bis unter 50 Jahre;17917;9178;8739
14511;      Chemnitz, Stadt;50 bis unter 55 Jahre;16849;8371;8478
14511;      Chemnitz, Stadt;55 bis unter 60 Jahre;18171;8575;9596
14511;      Chemnitz, Stadt;60 bis unter 65 Jahre;17958;8489;9469
14511;      Chemnitz, Stadt;65 bis unter 75 Jahre;35762;16458;19304
14511;      Chemnitz, Stadt;75 Jahre und mehr;29656;10570;19086
14511;      Chemnitz, Stadt;Insgesamt;243173;117404;125769
14521;      Erzgebirgskreis;unter 3 Jahre;8512;4341;4171
14521;      Erzgebirgskreis;3 bis unter 6 Jahre;8673;4497;4176
14521;      Erzgebirgskreis;6 bis unter 10 Jahre;11488;5838;5650
14521;      Erzgebirgskreis;10 bis unter 15 Jahre;13811;6971;6840
14521;      Erzgebirgskreis;15 bis unter 18 Jahre;7012;3585;3427
14521;      Erzgebirgskreis;18 bis unter 20 Jahre;4248;2237;2011
14521;      Erzgebirgskreis;20 bis unter 25 Jahre;17869;9780;8089
14521;      Erzgebirgskreis;25 bis unter 30 Jahre;19800;10745;9055
14521;      Erzgebirgskreis;30 bis unter 35 Jahre;20551;11077;9474
14521;      Erzgebirgskreis;35 bis unter 40 Jahre;18764;10101;8663
14521;      Erzgebirgskreis;40 bis unter 45 Jahre;23601;12305;11296
14521;      Erzgebirgskreis;45 bis unter 50 Jahre;28214;14300;13914
14521;      Erzgebirgskreis;50 bis unter 55 Jahre;29433;14599;14834
14521;      Erzgebirgskreis;55 bis unter 60 Jahre;32072;15947;16125
14521;      Erzgebirgskreis;60 bis unter 65 Jahre;29415;14664;14751
14521;      Erzgebirgskreis;65 bis unter 75 Jahre;45697;20982;24715
14521;      Erzgebirgskreis;75 Jahre und mehr;44581;15972;28609
14521;      Erzgebirgskreis;Insgesamt;363741;177941;185800
14522;      Mittelsachsen, Landkreis;unter 3 Jahre;7498;3820;3678
14522;      Mittelsachsen, Landkreis;3 bis unter 6 Jahre;7535;3887;3648
14522;      Mittelsachsen, Landkreis;6 bis unter 10 Jahre;9836;4993;4843
14522;      Mittelsachsen, Landkreis;10 bis unter 15 Jahre;12303;6344;5959
14522;      Mittelsachsen, Landkreis;15 bis unter 18 Jahre;6107;3155;2952
14522;      Mittelsachsen, Landkreis;18 bis unter 20 Jahre;3869;2067;1802
14522;      Mittelsachsen, Landkreis;20 bis unter 25 Jahre;16973;9428;7545
14522;      Mittelsachsen, Landkreis;25 bis unter 30 Jahre;18277;9988;8289
14522;      Mittelsachsen, Landkreis;30 bis unter 35 Jahre;18349;10008;8341
14522;      Mittelsachsen, Landkreis;35 bis unter 40 Jahre;16153;8751;7402
14522;      Mittelsachsen, Landkreis;40 bis unter 45 Jahre;22546;11697;10849
14522;      Mittelsachsen, Landkreis;45 bis unter 50 Jahre;27028;13892;13136
14522;      Mittelsachsen, Landkreis;50 bis unter 55 Jahre;26479;13424;13055
14522;      Mittelsachsen, Landkreis;55 bis unter 60 Jahre;26551;13371;13180
14522;      Mittelsachsen, Landkreis;60 bis unter 65 Jahre;22653;11188;11465
14522;      Mittelsachsen, Landkreis;65 bis unter 75 Jahre;42537;19839;22698
14522;      Mittelsachsen, Landkreis;75 Jahre und mehr;40210;14531;25679
14522;      Mittelsachsen, Landkreis;Insgesamt;324904;160383;164521
14523;      Vogtlandkreis;unter 3 Jahre;5042;2614;2428
14523;      Vogtlandkreis;3 bis unter 6 Jahre;5220;2759;2461
14523;      Vogtlandkreis;6 bis unter 10 Jahre;7010;3587;3423
14523;      Vogtlandkreis;10 bis unter 15 Jahre;8869;4589;4280
14523;      Vogtlandkreis;15 bis unter 18 Jahre;4391;2268;2123
14523;      Vogtlandkreis;18 bis unter 20 Jahre;2782;1437;1345
14523;      Vogtlandkreis;20 bis unter 25 Jahre;11955;6355;5600
14523;      Vogtlandkreis;25 bis unter 30 Jahre;12731;6825;5906
14523;      Vogtlandkreis;30 bis unter 35 Jahre;12700;6888;5812
14523;      Vogtlandkreis;35 bis unter 40 Jahre;12018;6389;5629
14523;      Vogtlandkreis;40 bis unter 45 Jahre;16691;8624;8067
14523;      Vogtlandkreis;45 bis unter 50 Jahre;20023;10195;9828
14523;      Vogtlandkreis;50 bis unter 55 Jahre;19760;9966;9794
14523;      Vogtlandkreis;55 bis unter 60 Jahre;19884;9788;10096
14523;      Vogtlandkreis;60 bis unter 65 Jahre;17731;8522;9209
14523;      Vogtlandkreis;65 bis unter 75 Jahre;34577;15949;18628
14523;      Vogtlandkreis;75 Jahre und mehr;30259;10332;19927
14523;      Vogtlandkreis;Insgesamt;241643;117087;124556
14524;      Zwickau, Landkreis;unter 3 Jahre;7536;3890;3646
14524;      Zwickau, Landkreis;3 bis unter 6 Jahre;7446;3816;3630
14524;      Zwickau, Landkreis;6 bis unter 10 Jahre;10053;5064;4989
14524;      Zwickau, Landkreis;10 bis unter 15 Jahre;12268;6336;5932
14524;      Zwickau, Landkreis;15 bis unter 18 Jahre;6190;3229;2961
14524;      Zwickau, Landkreis;18 bis unter 20 Jahre;4218;2148;2070
14524;      Zwickau, Landkreis;20 bis unter 25 Jahre;17647;9441;8206
14524;      Zwickau, Landkreis;25 bis unter 30 Jahre;18761;10113;8648
14524;      Zwickau, Landkreis;30 bis unter 35 Jahre;18148;9750;8398
14524;      Zwickau, Landkreis;35 bis unter 40 Jahre;16569;8810;7759
14524;      Zwickau, Landkreis;40 bis unter 45 Jahre;23288;11998;11290
14524;      Zwickau, Landkreis;45 bis unter 50 Jahre;28182;14362;13820
14524;      Zwickau, Landkreis;50 bis unter 55 Jahre;27033;13597;13436
14524;      Zwickau, Landkreis;55 bis unter 60 Jahre;27280;13380;13900
14524;      Zwickau, Landkreis;60 bis unter 65 Jahre;24341;11784;12557
14524;      Zwickau, Landkreis;65 bis unter 75 Jahre;46761;21522;25239
14524;      Zwickau, Landkreis;75 Jahre und mehr;42551;15049;27502
14524;      Zwickau, Landkreis;Insgesamt;338272;164289;173983
146;    Dresden, Direktionsbezirk;unter 3 Jahre;43089;22198;20891
146;    Dresden, Direktionsbezirk;3 bis unter 6 Jahre;41543;21225;20318
146;    Dresden, Direktionsbezirk;6 bis unter 10 Jahre;52227;26650;25577
146;    Dresden, Direktionsbezirk;10 bis unter 15 Jahre;60601;31175;29426
146;    Dresden, Direktionsbezirk;15 bis unter 18 Jahre;28770;14673;14097
146;    Dresden, Direktionsbezirk;18 bis unter 20 Jahre;20162;10460;9702
146;    Dresden, Direktionsbezirk;20 bis unter 25 Jahre;99491;52322;47169
146;    Dresden, Direktionsbezirk;25 bis unter 30 Jahre;107622;57463;50159
146;    Dresden, Direktionsbezirk;30 bis unter 35 Jahre;103274;55195;48079
146;    Dresden, Direktionsbezirk;35 bis unter 40 Jahre;87498;46635;40863
146;    Dresden, Direktionsbezirk;40 bis unter 45 Jahre;111145;58870;52275
146;    Dresden, Direktionsbezirk;45 bis unter 50 Jahre;132371;68427;63944
146;    Dresden, Direktionsbezirk;50 bis unter 55 Jahre;124039;63125;60914
146;    Dresden, Direktionsbezirk;55 bis unter 60 Jahre;118449;59187;59262
146;    Dresden, Direktionsbezirk;60 bis unter 65 Jahre;100091;48546;51545
146;    Dresden, Direktionsbezirk;65 bis unter 75 Jahre;210598;97359;113239
146;    Dresden, Direktionsbezirk;75 Jahre und mehr;183128;67150;115978
146;    Dresden, Direktionsbezirk;Insgesamt;1624098;800660;823438
14612;      Dresden, Stadt;unter 3 Jahre;17079;8748;8331
14612;      Dresden, Stadt;3 bis unter 6 Jahre;15041;7662;7379
14612;      Dresden, Stadt;6 bis unter 10 Jahre;16948;8648;8300
14612;      Dresden, Stadt;10 bis unter 15 Jahre;17950;9268;8682
14612;      Dresden, Stadt;15 bis unter 18 Jahre;7968;4034;3934
14612;      Dresden, Stadt;18 bis unter 20 Jahre;7558;3811;3747
14612;      Dresden, Stadt;20 bis unter 25 Jahre;45375;22952;22423
14612;      Dresden, Stadt;25 bis unter 30 Jahre;48761;25481;23280
14612;      Dresden, Stadt;30 bis unter 35 Jahre;42787;22631;20156
14612;      Dresden, Stadt;35 bis unter 40 Jahre;31813;17065;14748
14612;      Dresden, Stadt;40 bis unter 45 Jahre;35413;19072;16341
14612;      Dresden, Stadt;45 bis unter 50 Jahre;37483;19549;17934
14612;      Dresden, Stadt;50 bis unter 55 Jahre;32322;16319;16003
14612;      Dresden, Stadt;55 bis unter 60 Jahre;30506;14705;15801
14612;      Dresden, Stadt;60 bis unter 65 Jahre;27777;12967;14810
14612;      Dresden, Stadt;65 bis unter 75 Jahre;62840;28624;34216
14612;      Dresden, Stadt;75 Jahre und mehr;52160;19400;32760
14612;      Dresden, Stadt;Insgesamt;529781;260936;268845
14625;      Bautzen, Landkreis;unter 3 Jahre;7643;3890;3753
14625;      Bautzen, Landkreis;3 bis unter 6 Jahre;7775;3952;3823
14625;      Bautzen, Landkreis;6 bis unter 10 Jahre;10236;5253;4983
14625;      Bautzen, Landkreis;10 bis unter 15 Jahre;12644;6470;6174
14625;      Bautzen, Landkreis;15 bis unter 18 Jahre;5986;3063;2923
14625;      Bautzen, Landkreis;18 bis unter 20 Jahre;3653;1958;1695
14625;      Bautzen, Landkreis;20 bis unter 25 Jahre;15871;8835;7036
14625;      Bautzen, Landkreis;25 bis unter 30 Jahre;17555;9723;7832
14625;      Bautzen, Landkreis;30 bis unter 35 Jahre;18121;9812;8309
14625;      Bautzen, Landkreis;35 bis unter 40 Jahre;16611;8928;7683
14625;      Bautzen, Landkreis;40 bis unter 45 Jahre;21648;11402;10246
14625;      Bautzen, Landkreis;45 bis unter 50 Jahre;27820;14155;13665
14625;      Bautzen, Landkreis;50 bis unter 55 Jahre;27355;13909;13446
14625;      Bautzen, Landkreis;55 bis unter 60 Jahre;25908;13073;12835
14625;      Bautzen, Landkreis;60 bis unter 65 Jahre;20712;10328;10384
14625;      Bautzen, Landkreis;65 bis unter 75 Jahre;41689;19265;22424
14625;      Bautzen, Landkreis;75 Jahre und mehr;37391;13693;23698
14625;      Bautzen, Landkreis;Insgesamt;318618;157709;160909
14626;      Görlitz, Landkreis;unter 3 Jahre;6134;3168;2966
14626;      Görlitz, Landkreis;3 bis unter 6 Jahre;6300;3227;3073
14626;      Görlitz, Landkreis;6 bis unter 10 Jahre;8154;4125;4029
14626;      Görlitz, Landkreis;10 bis unter 15 Jahre;10325;5305;5020
14626;      Görlitz, Landkreis;15 bis unter 18 Jahre;5357;2736;2621
14626;      Görlitz, Landkreis;18 bis unter 20 Jahre;3324;1736;1588
14626;      Görlitz, Landkreis;20 bis unter 25 Jahre;13449;7194;6255
14626;      Görlitz, Landkreis;25 bis unter 30 Jahre;14383;7806;6577
14626;      Görlitz, Landkreis;30 bis unter 35 Jahre;13824;7596;6228
14626;      Görlitz, Landkreis;35 bis unter 40 Jahre;12788;6751;6037
14626;      Görlitz, Landkreis;40 bis unter 45 Jahre;18101;9445;8656
14626;      Görlitz, Landkreis;45 bis unter 50 Jahre;23280;11945;11335
14626;      Görlitz, Landkreis;50 bis unter 55 Jahre;23323;11902;11421
14626;      Görlitz, Landkreis;55 bis unter 60 Jahre;22534;11505;11029
14626;      Görlitz, Landkreis;60 bis unter 65 Jahre;19142;9351;9791
14626;      Görlitz, Landkreis;65 bis unter 75 Jahre;38174;17760;20414
14626;      Görlitz, Landkreis;75 Jahre und mehr;34919;12496;22423
14626;      Görlitz, Landkreis;Insgesamt;273511;134048;139463
14627;      Meißen, Landkreis;unter 3 Jahre;6062;3216;2846
14627;      Meißen, Landkreis;3 bis unter 6 Jahre;6168;3132;3036
14627;      Meißen, Landkreis;6 bis unter 10 Jahre;8402;4250;4152
14627;      Meißen, Landkreis;10 bis unter 15 Jahre;9721;4984;4737
14627;      Meißen, Landkreis;15 bis unter 18 Jahre;4672;2394;2278
14627;      Meißen, Landkreis;18 bis unter 20 Jahre;2847;1506;1341
14627;      Meißen, Landkreis;20 bis unter 25 Jahre;12181;6537;5644
14627;      Meißen, Landkreis;25 bis unter 30 Jahre;13624;7360;6264
14627;      Meißen, Landkreis;30 bis unter 35 Jahre;14301;7619;6682
14627;      Meißen, Landkreis;35 bis unter 40 Jahre;12918;6784;6134
14627;      Meißen, Landkreis;40 bis unter 45 Jahre;18096;9526;8570
14627;      Meißen, Landkreis;45 bis unter 50 Jahre;22277;11539;10738
14627;      Meißen, Landkreis;50 bis unter 55 Jahre;21008;10662;10346
14627;      Meißen, Landkreis;55 bis unter 60 Jahre;19950;10078;9872
14627;      Meißen, Landkreis;60 bis unter 65 Jahre;15812;7720;8092
14627;      Meißen, Landkreis;65 bis unter 75 Jahre;33656;15551;18105
14627;      Meißen, Landkreis;75 Jahre und mehr;29633;10853;18780
14627;      Meißen, Landkreis;Insgesamt;251328;123711;127617
14628;      Sächsische Schweiz-Osterzgebirge, Landkreis;unter 3 Jahre;6171;3176;2995
14628;      Sächsische Schweiz-Osterzgebirge, Landkreis;3 bis unter 6 Jahre;6259;3252;3007
14628;      Sächsische Schweiz-Osterzgebirge, Landkreis;6 bis unter 10 Jahre;8487;4374;4113
14628;      Sächsische Schweiz-Osterzgebirge, Landkreis;10 bis unter 15 Jahre;9961;5148;4813
14628;      Sächsische Schweiz-Osterzgebirge, Landkreis;15 bis unter 18 Jahre;4787;2446;2341
14628;      Sächsische Schweiz-Osterzgebirge, Landkreis;18 bis unter 20 Jahre;2780;1449;1331
14628;      Sächsische Schweiz-Osterzgebirge, Landkreis;20 bis unter 25 Jahre;12615;6804;5811
14628;      Sächsische Schweiz-Osterzgebirge, Landkreis;25 bis unter 30 Jahre;13299;7093;6206
14628;      Sächsische Schweiz-Osterzgebirge, Landkreis;30 bis unter 35 Jahre;14241;7537;6704
14628;      Sächsische Schweiz-Osterzgebirge, Landkreis;35 bis unter 40 Jahre;13368;7107;6261
14628;      Sächsische Schweiz-Osterzgebirge, Landkreis;40 bis unter 45 Jahre;17887;9425;8462
14628;      Sächsische Schweiz-Osterzgebirge, Landkreis;45 bis unter 50 Jahre;21511;11239;10272
14628;      Sächsische Schweiz-Osterzgebirge, Landkreis;50 bis unter 55 Jahre;20031;10333;9698
14628;      Sächsische Schweiz-Osterzgebirge, Landkreis;55 bis unter 60 Jahre;19551;9826;9725
14628;      Sächsische Schweiz-Osterzgebirge, Landkreis;60 bis unter 65 Jahre;16648;8180;8468
14628;      Sächsische Schweiz-Osterzgebirge, Landkreis;65 bis unter 75 Jahre;34239;16159;18080
14628;      Sächsische Schweiz-Osterzgebirge, Landkreis;75 Jahre und mehr;29025;10708;18317
14628;      Sächsische Schweiz-Osterzgebirge, Landkreis;Insgesamt;250860;124256;126604
147;    Leipzig, Direktionsbezirk;unter 3 Jahre;26312;13496;12816
147;    Leipzig, Direktionsbezirk;3 bis unter 6 Jahre;24842;12737;12105
147;    Leipzig, Direktionsbezirk;6 bis unter 10 Jahre;30717;15712;15005
147;    Leipzig, Direktionsbezirk;10 bis unter 15 Jahre;35297;18043;17254
147;    Leipzig, Direktionsbezirk;15 bis unter 18 Jahre;16900;8574;8326
147;    Leipzig, Direktionsbezirk;18 bis unter 20 Jahre;12526;6236;6290
147;    Leipzig, Direktionsbezirk;20 bis unter 25 Jahre;64783;32181;32602
147;    Leipzig, Direktionsbezirk;25 bis unter 30 Jahre;73573;37455;36118
147;    Leipzig, Direktionsbezirk;30 bis unter 35 Jahre;69652;36712;32940
147;    Leipzig, Direktionsbezirk;35 bis unter 40 Jahre;55144;29438;25706
147;    Leipzig, Direktionsbezirk;40 bis unter 45 Jahre;72588;38448;34140
147;    Leipzig, Direktionsbezirk;45 bis unter 50 Jahre;83055;43393;39662
147;    Leipzig, Direktionsbezirk;50 bis unter 55 Jahre;76560;39119;37441
147;    Leipzig, Direktionsbezirk;55 bis unter 60 Jahre;71927;36137;35790
147;    Leipzig, Direktionsbezirk;60 bis unter 65 Jahre;59411;28853;30558
147;    Leipzig, Direktionsbezirk;65 bis unter 75 Jahre;123476;56444;67032
147;    Leipzig, Direktionsbezirk;75 Jahre und mehr;104457;37284;67173
147;    Leipzig, Direktionsbezirk;Insgesamt;1001220;490262;510958
14713;      Leipzig, Stadt;unter 3 Jahre;15691;8044;7647
14713;      Leipzig, Stadt;3 bis unter 6 Jahre;13809;7070;6739
14713;      Leipzig, Stadt;6 bis unter 10 Jahre;15694;8026;7668
14713;      Leipzig, Stadt;10 bis unter 15 Jahre;16982;8650;8332
14713;      Leipzig, Stadt;15 bis unter 18 Jahre;7974;4021;3953
14713;      Leipzig, Stadt;18 bis unter 20 Jahre;7036;3288;3748
14713;      Leipzig, Stadt;20 bis unter 25 Jahre;40895;19173;21722
14713;      Leipzig, Stadt;25 bis unter 30 Jahre;48474;23973;24501
14713;      Leipzig, Stadt;30 bis unter 35 Jahre;43687;23028;20659
14713;      Leipzig, Stadt;35 bis unter 40 Jahre;31079;16772;14307
14713;      Leipzig, Stadt;40 bis unter 45 Jahre;37365;20153;17212
14713;      Leipzig, Stadt;45 bis unter 50 Jahre;39791;21115;18676
14713;      Leipzig, Stadt;50 bis unter 55 Jahre;34918;17786;17132
14713;      Leipzig, Stadt;55 bis unter 60 Jahre;33114;16407;16707
14713;      Leipzig, Stadt;60 bis unter 65 Jahre;28579;13545;15034
14713;      Leipzig, Stadt;65 bis unter 75 Jahre;63530;28646;34884
14713;      Leipzig, Stadt;75 Jahre und mehr;53191;18902;34289
14713;      Leipzig, Stadt;Insgesamt;531809;258599;273210
14729;      Leipzig, Landkreis;unter 3 Jahre;6092;3148;2944
14729;      Leipzig, Landkreis;3 bis unter 6 Jahre;6256;3207;3049
14729;      Leipzig, Landkreis;6 bis unter 10 Jahre;8516;4387;4129
14729;      Leipzig, Landkreis;10 bis unter 15 Jahre;10427;5293;5134
14729;      Leipzig, Landkreis;15 bis unter 18 Jahre;5019;2546;2473
14729;      Leipzig, Landkreis;18 bis unter 20 Jahre;3089;1643;1446
14729;      Leipzig, Landkreis;20 bis unter 25 Jahre;13149;7064;6085
14729;      Leipzig, Landkreis;25 bis unter 30 Jahre;13652;7310;6342
14729;      Leipzig, Landkreis;30 bis unter 35 Jahre;14424;7485;6939
14729;      Leipzig, Landkreis;35 bis unter 40 Jahre;13668;7151;6517
14729;      Leipzig, Landkreis;40 bis unter 45 Jahre;20262;10516;9746
14729;      Leipzig, Landkreis;45 bis unter 50 Jahre;24472;12586;11886
14729;      Leipzig, Landkreis;50 bis unter 55 Jahre;23214;11887;11327
14729;      Leipzig, Landkreis;55 bis unter 60 Jahre;21641;10918;10723
14729;      Leipzig, Landkreis;60 bis unter 65 Jahre;17813;8877;8936
14729;      Leipzig, Landkreis;65 bis unter 75 Jahre;34595;16027;18568
14729;      Leipzig, Landkreis;75 Jahre und mehr;28961;10495;18466
14729;      Leipzig, Landkreis;Insgesamt;265250;130540;134710
14730;      Nordsachsen, Landkreis;unter 3 Jahre;4529;2304;2225
14730;      Nordsachsen, Landkreis;3 bis unter 6 Jahre;4777;2460;2317
14730;      Nordsachsen, Landkreis;6 bis unter 10 Jahre;6507;3299;3208
14730;      Nordsachsen, Landkreis;10 bis unter 15 Jahre;7888;4100;3788
14730;      Nordsachsen, Landkreis;15 bis unter 18 Jahre;3907;2007;1900
14730;      Nordsachsen, Landkreis;18 bis unter 20 Jahre;2401;1305;1096
14730;      Nordsachsen, Landkreis;20 bis unter 25 Jahre;10739;5944;4795
14730;      Nordsachsen, Landkreis;25 bis unter 30 Jahre;11447;6172;5275
14730;      Nordsachsen, Landkreis;30 bis unter 35 Jahre;11541;6199;5342
14730;      Nordsachsen, Landkreis;35 bis unter 40 Jahre;10397;5515;4882
14730;      Nordsachsen, Landkreis;40 bis unter 45 Jahre;14961;7779;7182
14730;      Nordsachsen, Landkreis;45 bis unter 50 Jahre;18792;9692;9100
14730;      Nordsachsen, Landkreis;50 bis unter 55 Jahre;18428;9446;8982
14730;      Nordsachsen, Landkreis;55 bis unter 60 Jahre;17172;8812;8360
14730;      Nordsachsen, Landkreis;60 bis unter 65 Jahre;13019;6431;6588
14730;      Nordsachsen, Landkreis;65 bis unter 75 Jahre;25351;11771;13580
14730;      Nordsachsen, Landkreis;75 Jahre und mehr;22305;7887;14418
14730;      Nordsachsen, Landkreis;Insgesamt;204161;101123;103038
15;  Sachsen-Anhalt;unter 3 Jahre;51373;26329;25044
15;  Sachsen-Anhalt;3 bis unter 6 Jahre;51547;26588;24959
15;  Sachsen-Anhalt;6 bis unter 10 Jahre;66916;34473;32443
15;  Sachsen-Anhalt;10 bis unter 15 Jahre;83662;43230;40432
15;  Sachsen-Anhalt;15 bis unter 18 Jahre;42593;21971;20622
15;  Sachsen-Anhalt;18 bis unter 20 Jahre;29726;15354;14372
15;  Sachsen-Anhalt;20 bis unter 25 Jahre;136149;71826;64323
15;  Sachsen-Anhalt;25 bis unter 30 Jahre;138660;74734;63926
15;  Sachsen-Anhalt;30 bis unter 35 Jahre;129400;69872;59528
15;  Sachsen-Anhalt;35 bis unter 40 Jahre;113006;59893;53113
15;  Sachsen-Anhalt;40 bis unter 45 Jahre;166132;86288;79844
15;  Sachsen-Anhalt;45 bis unter 50 Jahre;201509;102810;98699
15;  Sachsen-Anhalt;50 bis unter 55 Jahre;196584;99187;97397
15;  Sachsen-Anhalt;55 bis unter 60 Jahre;189148;93931;95217
15;  Sachsen-Anhalt;60 bis unter 65 Jahre;155757;75656;80101
15;  Sachsen-Anhalt;65 bis unter 75 Jahre;306778;141640;165138
15;  Sachsen-Anhalt;75 Jahre und mehr;254340;90081;164259
15;  Sachsen-Anhalt;Insgesamt;2313280;1133863;1179417
15001;      Dessau-Roßlau, Kreisfreie Stadt;unter 3 Jahre;1778;903;875
15001;      Dessau-Roßlau, Kreisfreie Stadt;3 bis unter 6 Jahre;1741;886;855
15001;      Dessau-Roßlau, Kreisfreie Stadt;6 bis unter 10 Jahre;2178;1145;1033
15001;      Dessau-Roßlau, Kreisfreie Stadt;10 bis unter 15 Jahre;2698;1405;1293
15001;      Dessau-Roßlau, Kreisfreie Stadt;15 bis unter 18 Jahre;1418;707;711
15001;      Dessau-Roßlau, Kreisfreie Stadt;18 bis unter 20 Jahre;931;482;449
15001;      Dessau-Roßlau, Kreisfreie Stadt;20 bis unter 25 Jahre;4613;2408;2205
15001;      Dessau-Roßlau, Kreisfreie Stadt;25 bis unter 30 Jahre;4908;2628;2280
15001;      Dessau-Roßlau, Kreisfreie Stadt;30 bis unter 35 Jahre;4411;2361;2050
15001;      Dessau-Roßlau, Kreisfreie Stadt;35 bis unter 40 Jahre;3706;1884;1822
15001;      Dessau-Roßlau, Kreisfreie Stadt;40 bis unter 45 Jahre;5703;2946;2757
15001;      Dessau-Roßlau, Kreisfreie Stadt;45 bis unter 50 Jahre;7224;3549;3675
15001;      Dessau-Roßlau, Kreisfreie Stadt;50 bis unter 55 Jahre;6888;3462;3426
15001;      Dessau-Roßlau, Kreisfreie Stadt;55 bis unter 60 Jahre;6952;3350;3602
15001;      Dessau-Roßlau, Kreisfreie Stadt;60 bis unter 65 Jahre;6245;2933;3312
15001;      Dessau-Roßlau, Kreisfreie Stadt;65 bis unter 75 Jahre;13717;6389;7328
15001;      Dessau-Roßlau, Kreisfreie Stadt;75 Jahre und mehr;10727;3909;6818
15001;      Dessau-Roßlau, Kreisfreie Stadt;Insgesamt;85838;41347;44491
15002;      Halle (Saale), Kreisfreie Stadt;unter 3 Jahre;6264;3184;3080
15002;      Halle (Saale), Kreisfreie Stadt;3 bis unter 6 Jahre;5801;3005;2796
15002;      Halle (Saale), Kreisfreie Stadt;6 bis unter 10 Jahre;7018;3612;3406
15002;      Halle (Saale), Kreisfreie Stadt;10 bis unter 15 Jahre;7856;4010;3846
15002;      Halle (Saale), Kreisfreie Stadt;15 bis unter 18 Jahre;3886;1974;1912
15002;      Halle (Saale), Kreisfreie Stadt;18 bis unter 20 Jahre;3721;1693;2028
15002;      Halle (Saale), Kreisfreie Stadt;20 bis unter 25 Jahre;19428;8848;10580
15002;      Halle (Saale), Kreisfreie Stadt;25 bis unter 30 Jahre;18648;9459;9189
15002;      Halle (Saale), Kreisfreie Stadt;30 bis unter 35 Jahre;15466;8341;7125
15002;      Halle (Saale), Kreisfreie Stadt;35 bis unter 40 Jahre;12131;6441;5690
15002;      Halle (Saale), Kreisfreie Stadt;40 bis unter 45 Jahre;15617;8202;7415
15002;      Halle (Saale), Kreisfreie Stadt;45 bis unter 50 Jahre;17098;8674;8424
15002;      Halle (Saale), Kreisfreie Stadt;50 bis unter 55 Jahre;15311;7504;7807
15002;      Halle (Saale), Kreisfreie Stadt;55 bis unter 60 Jahre;16132;7495;8637
15002;      Halle (Saale), Kreisfreie Stadt;60 bis unter 65 Jahre;14786;6742;8044
15002;      Halle (Saale), Kreisfreie Stadt;65 bis unter 75 Jahre;30716;13859;16857
15002;      Halle (Saale), Kreisfreie Stadt;75 Jahre und mehr;23826;8300;15526
15002;      Halle (Saale), Kreisfreie Stadt;Insgesamt;233705;111343;122362
15003;      Magdeburg, Kreisfreie Stadt;unter 3 Jahre;5859;2992;2867
15003;      Magdeburg, Kreisfreie Stadt;3 bis unter 6 Jahre;5460;2823;2637
15003;      Magdeburg, Kreisfreie Stadt;6 bis unter 10 Jahre;6410;3242;3168
15003;      Magdeburg, Kreisfreie Stadt;10 bis unter 15 Jahre;7376;3901;3475
15003;      Magdeburg, Kreisfreie Stadt;15 bis unter 18 Jahre;3717;1883;1834
15003;      Magdeburg, Kreisfreie Stadt;18 bis unter 20 Jahre;3325;1662;1663
15003;      Magdeburg, Kreisfreie Stadt;20 bis unter 25 Jahre;19212;9753;9459
15003;      Magdeburg, Kreisfreie Stadt;25 bis unter 30 Jahre;18873;9960;8913
15003;      Magdeburg, Kreisfreie Stadt;30 bis unter 35 Jahre;15305;8235;7070
15003;      Magdeburg, Kreisfreie Stadt;35 bis unter 40 Jahre;11531;6210;5321
15003;      Magdeburg, Kreisfreie Stadt;40 bis unter 45 Jahre;15586;8220;7366
15003;      Magdeburg, Kreisfreie Stadt;45 bis unter 50 Jahre;17716;9066;8650
15003;      Magdeburg, Kreisfreie Stadt;50 bis unter 55 Jahre;16384;8095;8289
15003;      Magdeburg, Kreisfreie Stadt;55 bis unter 60 Jahre;16113;7613;8500
15003;      Magdeburg, Kreisfreie Stadt;60 bis unter 65 Jahre;14643;6771;7872
15003;      Magdeburg, Kreisfreie Stadt;65 bis unter 75 Jahre;30816;13952;16864
15003;      Magdeburg, Kreisfreie Stadt;75 Jahre und mehr;24038;8698;15340
15003;      Magdeburg, Kreisfreie Stadt;Insgesamt;232364;113076;119288
15081;      Altmarkkreis Salzwedel;unter 3 Jahre;2042;1054;988
15081;      Altmarkkreis Salzwedel;3 bis unter 6 Jahre;2110;1112;998
15081;      Altmarkkreis Salzwedel;6 bis unter 10 Jahre;2747;1414;1333
15081;      Altmarkkreis Salzwedel;10 bis unter 15 Jahre;3715;1956;1759
15081;      Altmarkkreis Salzwedel;15 bis unter 18 Jahre;2006;1021;985
15081;      Altmarkkreis Salzwedel;18 bis unter 20 Jahre;1190;626;564
15081;      Altmarkkreis Salzwedel;20 bis unter 25 Jahre;4850;2767;2083
15081;      Altmarkkreis Salzwedel;25 bis unter 30 Jahre;5047;2838;2209
15081;      Altmarkkreis Salzwedel;30 bis unter 35 Jahre;4710;2562;2148
15081;      Altmarkkreis Salzwedel;35 bis unter 40 Jahre;4330;2296;2034
15081;      Altmarkkreis Salzwedel;40 bis unter 45 Jahre;6517;3370;3147
15081;      Altmarkkreis Salzwedel;45 bis unter 50 Jahre;8564;4502;4062
15081;      Altmarkkreis Salzwedel;50 bis unter 55 Jahre;8383;4244;4139
15081;      Altmarkkreis Salzwedel;55 bis unter 60 Jahre;7288;3745;3543
15081;      Altmarkkreis Salzwedel;60 bis unter 65 Jahre;5453;2747;2706
15081;      Altmarkkreis Salzwedel;65 bis unter 75 Jahre;10340;4775;5565
15081;      Altmarkkreis Salzwedel;75 Jahre und mehr;9146;3305;5841
15081;      Altmarkkreis Salzwedel;Insgesamt;88438;44334;44104
15082;      Anhalt-Bitterfeld, Landkreis;unter 3 Jahre;3650;1906;1744
15082;      Anhalt-Bitterfeld, Landkreis;3 bis unter 6 Jahre;3625;1818;1807
15082;      Anhalt-Bitterfeld, Landkreis;6 bis unter 10 Jahre;4785;2455;2330
15082;      Anhalt-Bitterfeld, Landkreis;10 bis unter 15 Jahre;6220;3198;3022
15082;      Anhalt-Bitterfeld, Landkreis;15 bis unter 18 Jahre;3175;1675;1500
15082;      Anhalt-Bitterfeld, Landkreis;18 bis unter 20 Jahre;2088;1091;997
15082;      Anhalt-Bitterfeld, Landkreis;20 bis unter 25 Jahre;9778;5370;4408
15082;      Anhalt-Bitterfeld, Landkreis;25 bis unter 30 Jahre;9493;5209;4284
15082;      Anhalt-Bitterfeld, Landkreis;30 bis unter 35 Jahre;9069;4889;4180
15082;      Anhalt-Bitterfeld, Landkreis;35 bis unter 40 Jahre;8530;4552;3978
15082;      Anhalt-Bitterfeld, Landkreis;40 bis unter 45 Jahre;12535;6426;6109
15082;      Anhalt-Bitterfeld, Landkreis;45 bis unter 50 Jahre;15362;7763;7599
15082;      Anhalt-Bitterfeld, Landkreis;50 bis unter 55 Jahre;15414;7763;7651
15082;      Anhalt-Bitterfeld, Landkreis;55 bis unter 60 Jahre;14962;7513;7449
15082;      Anhalt-Bitterfeld, Landkreis;60 bis unter 65 Jahre;11888;5814;6074
15082;      Anhalt-Bitterfeld, Landkreis;65 bis unter 75 Jahre;23937;10975;12962
15082;      Anhalt-Bitterfeld, Landkreis;75 Jahre und mehr;19724;6817;12907
15082;      Anhalt-Bitterfeld, Landkreis;Insgesamt;174235;85234;89001
15083;      Börde, Landkreis;unter 3 Jahre;4090;2087;2003
15083;      Börde, Landkreis;3 bis unter 6 Jahre;4307;2246;2061
15083;      Börde, Landkreis;6 bis unter 10 Jahre;5478;2855;2623
15083;      Börde, Landkreis;10 bis unter 15 Jahre;7095;3650;3445
15083;      Börde, Landkreis;15 bis unter 18 Jahre;3443;1785;1658
15083;      Börde, Landkreis;18 bis unter 20 Jahre;2185;1142;1043
15083;      Börde, Landkreis;20 bis unter 25 Jahre;9281;5014;4267
15083;      Börde, Landkreis;25 bis unter 30 Jahre;9941;5351;4590
15083;      Börde, Landkreis;30 bis unter 35 Jahre;10341;5599;4742
15083;      Börde, Landkreis;35 bis unter 40 Jahre;9377;4884;4493
15083;      Börde, Landkreis;40 bis unter 45 Jahre;14014;7272;6742
15083;      Börde, Landkreis;45 bis unter 50 Jahre;16712;8605;8107
15083;      Börde, Landkreis;50 bis unter 55 Jahre;16716;8570;8146
15083;      Börde, Landkreis;55 bis unter 60 Jahre;15376;7831;7545
15083;      Börde, Landkreis;60 bis unter 65 Jahre;11735;5977;5758
15083;      Börde, Landkreis;65 bis unter 75 Jahre;20094;9518;10576
15083;      Börde, Landkreis;75 Jahre und mehr;17117;5953;11164
15083;      Börde, Landkreis;Insgesamt;177302;88339;88963
15084;      Burgenlandkreis;unter 3 Jahre;3890;2041;1849
15084;      Burgenlandkreis;3 bis unter 6 Jahre;4061;2116;1945
15084;      Burgenlandkreis;6 bis unter 10 Jahre;5481;2797;2684
15084;      Burgenlandkreis;10 bis unter 15 Jahre;6805;3532;3273
15084;      Burgenlandkreis;15 bis unter 18 Jahre;3290;1673;1617
15084;      Burgenlandkreis;18 bis unter 20 Jahre;2198;1187;1011
15084;      Burgenlandkreis;20 bis unter 25 Jahre;9905;5418;4487
15084;      Burgenlandkreis;25 bis unter 30 Jahre;10624;5868;4756
15084;      Burgenlandkreis;30 bis unter 35 Jahre;10329;5678;4651
15084;      Burgenlandkreis;35 bis unter 40 Jahre;8927;4882;4045
15084;      Burgenlandkreis;40 bis unter 45 Jahre;13665;7125;6540
15084;      Burgenlandkreis;45 bis unter 50 Jahre;16762;8641;8121
15084;      Burgenlandkreis;50 bis unter 55 Jahre;17140;8737;8403
15084;      Burgenlandkreis;55 bis unter 60 Jahre;16203;8119;8084
15084;      Burgenlandkreis;60 bis unter 65 Jahre;12708;6249;6459
15084;      Burgenlandkreis;65 bis unter 75 Jahre;25858;11965;13893
15084;      Burgenlandkreis;75 Jahre und mehr;23638;8276;15362
15084;      Burgenlandkreis;Insgesamt;191484;94304;97180
15085;      Harz, Landkreis;unter 3 Jahre;4676;2369;2307
15085;      Harz, Landkreis;3 bis unter 6 Jahre;4903;2531;2372
15085;      Harz, Landkreis;6 bis unter 10 Jahre;6787;3513;3274
15085;      Harz, Landkreis;10 bis unter 15 Jahre;8609;4447;4162
15085;      Harz, Landkreis;15 bis unter 18 Jahre;4322;2241;2081
15085;      Harz, Landkreis;18 bis unter 20 Jahre;2960;1535;1425
15085;      Harz, Landkreis;20 bis unter 25 Jahre;11958;6467;5491
15085;      Harz, Landkreis;25 bis unter 30 Jahre;12592;6804;5788
15085;      Harz, Landkreis;30 bis unter 35 Jahre;12306;6571;5735
15085;      Harz, Landkreis;35 bis unter 40 Jahre;10742;5694;5048
15085;      Harz, Landkreis;40 bis unter 45 Jahre;16454;8441;8013
15085;      Harz, Landkreis;45 bis unter 50 Jahre;20122;10267;9855
15085;      Harz, Landkreis;50 bis unter 55 Jahre;19686;9931;9755
15085;      Harz, Landkreis;55 bis unter 60 Jahre;19160;9558;9602
15085;      Harz, Landkreis;60 bis unter 65 Jahre;16198;7857;8341
15085;      Harz, Landkreis;65 bis unter 75 Jahre;31238;14445;16793
15085;      Harz, Landkreis;75 Jahre und mehr;26463;9253;17210
15085;      Harz, Landkreis;Insgesamt;229176;111924;117252
15086;      Jerichower Land, Landkreis;unter 3 Jahre;1985;973;1012
15086;      Jerichower Land, Landkreis;3 bis unter 6 Jahre;2150;1080;1070
15086;      Jerichower Land, Landkreis;6 bis unter 10 Jahre;2818;1458;1360
15086;      Jerichower Land, Landkreis;10 bis unter 15 Jahre;3706;1955;1751
15086;      Jerichower Land, Landkreis;15 bis unter 18 Jahre;1916;1024;892
15086;      Jerichower Land, Landkreis;18 bis unter 20 Jahre;1166;614;552
15086;      Jerichower Land, Landkreis;20 bis unter 25 Jahre;4856;2727;2129
15086;      Jerichower Land, Landkreis;25 bis unter 30 Jahre;5030;2803;2227
15086;      Jerichower Land, Landkreis;30 bis unter 35 Jahre;5196;2783;2413
15086;      Jerichower Land, Landkreis;35 bis unter 40 Jahre;4769;2522;2247
15086;      Jerichower Land, Landkreis;40 bis unter 45 Jahre;6999;3643;3356
15086;      Jerichower Land, Landkreis;45 bis unter 50 Jahre;9005;4576;4429
15086;      Jerichower Land, Landkreis;50 bis unter 55 Jahre;9011;4629;4382
15086;      Jerichower Land, Landkreis;55 bis unter 60 Jahre;8219;4192;4027
15086;      Jerichower Land, Landkreis;60 bis unter 65 Jahre;6281;3145;3136
15086;      Jerichower Land, Landkreis;65 bis unter 75 Jahre;11876;5502;6374
15086;      Jerichower Land, Landkreis;75 Jahre und mehr;10196;3645;6551
15086;      Jerichower Land, Landkreis;Insgesamt;95179;47271;47908
15087;      Mansfeld-Südharz, Landkreis;unter 3 Jahre;2918;1496;1422
15087;      Mansfeld-Südharz, Landkreis;3 bis unter 6 Jahre;3050;1555;1495
15087;      Mansfeld-Südharz, Landkreis;6 bis unter 10 Jahre;4128;2069;2059
15087;      Mansfeld-Südharz, Landkreis;10 bis unter 15 Jahre;5239;2759;2480
15087;      Mansfeld-Südharz, Landkreis;15 bis unter 18 Jahre;2695;1394;1301
15087;      Mansfeld-Südharz, Landkreis;18 bis unter 20 Jahre;1819;994;825
15087;      Mansfeld-Südharz, Landkreis;20 bis unter 25 Jahre;7089;3896;3193
15087;      Mansfeld-Südharz, Landkreis;25 bis unter 30 Jahre;7611;4257;3354
15087;      Mansfeld-Südharz, Landkreis;30 bis unter 35 Jahre;7579;4082;3497
15087;      Mansfeld-Südharz, Landkreis;35 bis unter 40 Jahre;7103;3765;3338
15087;      Mansfeld-Südharz, Landkreis;40 bis unter 45 Jahre;10056;5221;4835
15087;      Mansfeld-Südharz, Landkreis;45 bis unter 50 Jahre;12906;6479;6427
15087;      Mansfeld-Südharz, Landkreis;50 bis unter 55 Jahre;13221;6805;6416
15087;      Mansfeld-Südharz, Landkreis;55 bis unter 60 Jahre;12905;6513;6392
15087;      Mansfeld-Südharz, Landkreis;60 bis unter 65 Jahre;10776;5235;5541
15087;      Mansfeld-Südharz, Landkreis;65 bis unter 75 Jahre;20962;9772;11190
15087;      Mansfeld-Südharz, Landkreis;75 Jahre und mehr;18008;6555;11453
15087;      Mansfeld-Südharz, Landkreis;Insgesamt;148065;72847;75218
15088;      Saalekreis;unter 3 Jahre;4450;2285;2165
15088;      Saalekreis;3 bis unter 6 Jahre;4466;2328;2138
15088;      Saalekreis;6 bis unter 10 Jahre;5884;3084;2800
15088;      Saalekreis;10 bis unter 15 Jahre;7209;3606;3603
15088;      Saalekreis;15 bis unter 18 Jahre;3722;1918;1804
15088;      Saalekreis;18 bis unter 20 Jahre;2313;1266;1047
15088;      Saalekreis;20 bis unter 25 Jahre;10334;5651;4683
15088;      Saalekreis;25 bis unter 30 Jahre;10824;5786;5038
15088;      Saalekreis;30 bis unter 35 Jahre;11104;5967;5137
15088;      Saalekreis;35 bis unter 40 Jahre;10057;5309;4748
15088;      Saalekreis;40 bis unter 45 Jahre;15125;7820;7305
15088;      Saalekreis;45 bis unter 50 Jahre;17819;9148;8671
15088;      Saalekreis;50 bis unter 55 Jahre;16831;8496;8335
15088;      Saalekreis;55 bis unter 60 Jahre;16851;8417;8434
15088;      Saalekreis;60 bis unter 65 Jahre;13798;6872;6926
15088;      Saalekreis;65 bis unter 75 Jahre;24442;11471;12971
15088;      Saalekreis;75 Jahre und mehr;19904;7168;12736
15088;      Saalekreis;Insgesamt;195133;96592;98541
15089;      Salzlandkreis;unter 3 Jahre;4227;2139;2088
15089;      Salzlandkreis;3 bis unter 6 Jahre;4404;2305;2099
15089;      Salzlandkreis;6 bis unter 10 Jahre;5777;2926;2851
15089;      Salzlandkreis;10 bis unter 15 Jahre;7369;3812;3557
15089;      Salzlandkreis;15 bis unter 18 Jahre;4000;2070;1930
15089;      Salzlandkreis;18 bis unter 20 Jahre;2501;1316;1185
15089;      Salzlandkreis;20 bis unter 25 Jahre;11114;5974;5140
15089;      Salzlandkreis;25 bis unter 30 Jahre;11232;6229;5003
15089;      Salzlandkreis;30 bis unter 35 Jahre;10742;5850;4892
15089;      Salzlandkreis;35 bis unter 40 Jahre;9611;5091;4520
15089;      Salzlandkreis;40 bis unter 45 Jahre;15265;7916;7349
15089;      Salzlandkreis;45 bis unter 50 Jahre;18328;9314;9014
15089;      Salzlandkreis;50 bis unter 55 Jahre;18101;9056;9045
15089;      Salzlandkreis;55 bis unter 60 Jahre;17110;8590;8520
15089;      Salzlandkreis;60 bis unter 65 Jahre;14184;6872;7312
15089;      Salzlandkreis;65 bis unter 75 Jahre;28862;13317;15545
15089;      Salzlandkreis;75 Jahre und mehr;23957;8353;15604
15089;      Salzlandkreis;Insgesamt;206784;101130;105654
15090;      Stendal, Landkreis;unter 3 Jahre;2753;1432;1321
15090;      Stendal, Landkreis;3 bis unter 6 Jahre;2703;1350;1353
15090;      Stendal, Landkreis;6 bis unter 10 Jahre;3671;1930;1741
15090;      Stendal, Landkreis;10 bis unter 15 Jahre;4899;2443;2456
15090;      Stendal, Landkreis;15 bis unter 18 Jahre;2545;1328;1217
15090;      Stendal, Landkreis;18 bis unter 20 Jahre;1720;904;816
15090;      Stendal, Landkreis;20 bis unter 25 Jahre;6795;3698;3097
15090;      Stendal, Landkreis;25 bis unter 30 Jahre;6720;3667;3053
15090;      Stendal, Landkreis;30 bis unter 35 Jahre;6101;3338;2763
15090;      Stendal, Landkreis;35 bis unter 40 Jahre;5633;2915;2718
15090;      Stendal, Landkreis;40 bis unter 45 Jahre;8901;4588;4313
15090;      Stendal, Landkreis;45 bis unter 50 Jahre;11527;5888;5639
15090;      Stendal, Landkreis;50 bis unter 55 Jahre;11251;5696;5555
15090;      Stendal, Landkreis;55 bis unter 60 Jahre;10196;5217;4979
15090;      Stendal, Landkreis;60 bis unter 65 Jahre;7689;3767;3922
15090;      Stendal, Landkreis;65 bis unter 75 Jahre;14877;6976;7901
15090;      Stendal, Landkreis;75 Jahre und mehr;12201;4399;7802
15090;      Stendal, Landkreis;Insgesamt;120182;59536;60646
15091;      Wittenberg, Landkreis;unter 3 Jahre;2791;1468;1323
15091;      Wittenberg, Landkreis;3 bis unter 6 Jahre;2766;1433;1333
15091;      Wittenberg, Landkreis;6 bis unter 10 Jahre;3754;1973;1781
15091;      Wittenberg, Landkreis;10 bis unter 15 Jahre;4866;2556;2310
15091;      Wittenberg, Landkreis;15 bis unter 18 Jahre;2458;1278;1180
15091;      Wittenberg, Landkreis;18 bis unter 20 Jahre;1609;842;767
15091;      Wittenberg, Landkreis;20 bis unter 25 Jahre;6936;3835;3101
15091;      Wittenberg, Landkreis;25 bis unter 30 Jahre;7117;3875;3242
15091;      Wittenberg, Landkreis;30 bis unter 35 Jahre;6741;3616;3125
15091;      Wittenberg, Landkreis;35 bis unter 40 Jahre;6559;3448;3111
15091;      Wittenberg, Landkreis;40 bis unter 45 Jahre;9695;5098;4597
15091;      Wittenberg, Landkreis;45 bis unter 50 Jahre;12364;6338;6026
15091;      Wittenberg, Landkreis;50 bis unter 55 Jahre;12247;6199;6048
15091;      Wittenberg, Landkreis;55 bis unter 60 Jahre;11681;5778;5903
15091;      Wittenberg, Landkreis;60 bis unter 65 Jahre;9373;4675;4698
15091;      Wittenberg, Landkreis;65 bis unter 75 Jahre;19043;8724;10319
15091;      Wittenberg, Landkreis;75 Jahre und mehr;15395;5450;9945
15091;      Wittenberg, Landkreis;Insgesamt;135395;66586;68809
151;    Dessau, Stat. Region;unter 3 Jahre;-;-;-
151;    Dessau, Stat. Region;3 bis unter 6 Jahre;-;-;-
151;    Dessau, Stat. Region;6 bis unter 10 Jahre;-;-;-
151;    Dessau, Stat. Region;10 bis unter 15 Jahre;-;-;-
151;    Dessau, Stat. Region;15 bis unter 18 Jahre;-;-;-
151;    Dessau, Stat. Region;18 bis unter 20 Jahre;-;-;-
151;    Dessau, Stat. Region;20 bis unter 25 Jahre;-;-;-
151;    Dessau, Stat. Region;25 bis unter 30 Jahre;-;-;-
151;    Dessau, Stat. Region;30 bis unter 35 Jahre;-;-;-
151;    Dessau, Stat. Region;35 bis unter 40 Jahre;-;-;-
151;    Dessau, Stat. Region;40 bis unter 45 Jahre;-;-;-
151;    Dessau, Stat. Region;45 bis unter 50 Jahre;-;-;-
151;    Dessau, Stat. Region;50 bis unter 55 Jahre;-;-;-
151;    Dessau, Stat. Region;55 bis unter 60 Jahre;-;-;-
151;    Dessau, Stat. Region;60 bis unter 65 Jahre;-;-;-
151;    Dessau, Stat. Region;65 bis unter 75 Jahre;-;-;-
151;    Dessau, Stat. Region;75 Jahre und mehr;-;-;-
151;    Dessau, Stat. Region;Insgesamt;-;-;-
16;  Thüringen;unter 3 Jahre;51802;26288;25514
16;  Thüringen;3 bis unter 6 Jahre;50893;26241;24652
16;  Thüringen;6 bis unter 10 Jahre;66724;34147;32577
16;  Thüringen;10 bis unter 15 Jahre;82169;42036;40133
16;  Thüringen;15 bis unter 18 Jahre;41004;21083;19921
16;  Thüringen;18 bis unter 20 Jahre;27813;14234;13579
16;  Thüringen;20 bis unter 25 Jahre;130028;67731;62297
16;  Thüringen;25 bis unter 30 Jahre;139050;74992;64058
16;  Thüringen;30 bis unter 35 Jahre;132521;71478;61043
16;  Thüringen;35 bis unter 40 Jahre;116323;62943;53380
16;  Thüringen;40 bis unter 45 Jahre;157745;82793;74952
16;  Thüringen;45 bis unter 50 Jahre;190697;98097;92600
16;  Thüringen;50 bis unter 55 Jahre;189597;96376;93221
16;  Thüringen;55 bis unter 60 Jahre;181309;90898;90411
16;  Thüringen;60 bis unter 65 Jahre;150023;74051;75972
16;  Thüringen;65 bis unter 75 Jahre;281713;130592;151121
16;  Thüringen;75 Jahre und mehr;231811;83324;148487
16;  Thüringen;Insgesamt;2221222;1097304;1123918
16051;      Erfurt, krsfr. Stadt;unter 3 Jahre;5618;2846;2772
16051;      Erfurt, krsfr. Stadt;3 bis unter 6 Jahre;5304;2708;2596
16051;      Erfurt, krsfr. Stadt;6 bis unter 10 Jahre;6285;3171;3114
16051;      Erfurt, krsfr. Stadt;10 bis unter 15 Jahre;7422;3808;3614
16051;      Erfurt, krsfr. Stadt;15 bis unter 18 Jahre;3491;1789;1702
16051;      Erfurt, krsfr. Stadt;18 bis unter 20 Jahre;2732;1259;1473
16051;      Erfurt, krsfr. Stadt;20 bis unter 25 Jahre;16055;7371;8684
16051;      Erfurt, krsfr. Stadt;25 bis unter 30 Jahre;16022;8253;7769
16051;      Erfurt, krsfr. Stadt;30 bis unter 35 Jahre;14671;7710;6961
16051;      Erfurt, krsfr. Stadt;35 bis unter 40 Jahre;11475;6147;5328
16051;      Erfurt, krsfr. Stadt;40 bis unter 45 Jahre;14461;7509;6952
16051;      Erfurt, krsfr. Stadt;45 bis unter 50 Jahre;16440;8459;7981
16051;      Erfurt, krsfr. Stadt;50 bis unter 55 Jahre;15585;7807;7778
16051;      Erfurt, krsfr. Stadt;55 bis unter 60 Jahre;14980;7192;7788
16051;      Erfurt, krsfr. Stadt;60 bis unter 65 Jahre;12668;6107;6561
16051;      Erfurt, krsfr. Stadt;65 bis unter 75 Jahre;24334;11140;13194
16051;      Erfurt, krsfr. Stadt;75 Jahre und mehr;18841;6752;12089
16051;      Erfurt, krsfr. Stadt;Insgesamt;206384;100028;106356
16052;      Gera, krsfr. Stadt;unter 3 Jahre;2163;1113;1050
16052;      Gera, krsfr. Stadt;3 bis unter 6 Jahre;2036;1057;979
16052;      Gera, krsfr. Stadt;6 bis unter 10 Jahre;2638;1331;1307
16052;      Gera, krsfr. Stadt;10 bis unter 15 Jahre;3113;1581;1532
16052;      Gera, krsfr. Stadt;15 bis unter 18 Jahre;1507;807;700
16052;      Gera, krsfr. Stadt;18 bis unter 20 Jahre;1054;501;553
16052;      Gera, krsfr. Stadt;20 bis unter 25 Jahre;5589;2782;2807
16052;      Gera, krsfr. Stadt;25 bis unter 30 Jahre;5946;3172;2774
16052;      Gera, krsfr. Stadt;30 bis unter 35 Jahre;5424;2929;2495
16052;      Gera, krsfr. Stadt;35 bis unter 40 Jahre;4584;2496;2088
16052;      Gera, krsfr. Stadt;40 bis unter 45 Jahre;6563;3391;3172
16052;      Gera, krsfr. Stadt;45 bis unter 50 Jahre;8414;4290;4124
16052;      Gera, krsfr. Stadt;50 bis unter 55 Jahre;8522;4316;4206
16052;      Gera, krsfr. Stadt;55 bis unter 60 Jahre;8664;4255;4409
16052;      Gera, krsfr. Stadt;60 bis unter 65 Jahre;6943;3347;3596
16052;      Gera, krsfr. Stadt;65 bis unter 75 Jahre;13642;6164;7478
16052;      Gera, krsfr. Stadt;75 Jahre und mehr;11960;4212;7748
16052;      Gera, krsfr. Stadt;Insgesamt;98762;47744;51018
16053;      Jena, krsfr. Stadt;unter 3 Jahre;3210;1633;1577
16053;      Jena, krsfr. Stadt;3 bis unter 6 Jahre;2785;1396;1389
16053;      Jena, krsfr. Stadt;6 bis unter 10 Jahre;3151;1575;1576
16053;      Jena, krsfr. Stadt;10 bis unter 15 Jahre;3333;1755;1578
16053;      Jena, krsfr. Stadt;15 bis unter 18 Jahre;1612;816;796
16053;      Jena, krsfr. Stadt;18 bis unter 20 Jahre;1496;726;770
16053;      Jena, krsfr. Stadt;20 bis unter 25 Jahre;10509;4824;5685
16053;      Jena, krsfr. Stadt;25 bis unter 30 Jahre;10619;5705;4914
16053;      Jena, krsfr. Stadt;30 bis unter 35 Jahre;8081;4463;3618
16053;      Jena, krsfr. Stadt;35 bis unter 40 Jahre;6122;3492;2630
16053;      Jena, krsfr. Stadt;40 bis unter 45 Jahre;6779;3736;3043
16053;      Jena, krsfr. Stadt;45 bis unter 50 Jahre;7302;3839;3463
16053;      Jena, krsfr. Stadt;50 bis unter 55 Jahre;6433;3245;3188
16053;      Jena, krsfr. Stadt;55 bis unter 60 Jahre;6601;3134;3467
16053;      Jena, krsfr. Stadt;60 bis unter 65 Jahre;5810;2693;3117
16053;      Jena, krsfr. Stadt;65 bis unter 75 Jahre;12514;5761;6753
16053;      Jena, krsfr. Stadt;75 Jahre und mehr;9106;3447;5659
16053;      Jena, krsfr. Stadt;Insgesamt;105463;52240;53223
16054;      Suhl, krsfr. Stadt;unter 3 Jahre;650;344;306
16054;      Suhl, krsfr. Stadt;3 bis unter 6 Jahre;664;333;331
16054;      Suhl, krsfr. Stadt;6 bis unter 10 Jahre;866;461;405
16054;      Suhl, krsfr. Stadt;10 bis unter 15 Jahre;1190;600;590
16054;      Suhl, krsfr. Stadt;15 bis unter 18 Jahre;571;309;262
16054;      Suhl, krsfr. Stadt;18 bis unter 20 Jahre;438;221;217
16054;      Suhl, krsfr. Stadt;20 bis unter 25 Jahre;1955;1055;900
16054;      Suhl, krsfr. Stadt;25 bis unter 30 Jahre;2021;1114;907
16054;      Suhl, krsfr. Stadt;30 bis unter 35 Jahre;1911;1047;864
16054;      Suhl, krsfr. Stadt;35 bis unter 40 Jahre;1720;969;751
16054;      Suhl, krsfr. Stadt;40 bis unter 45 Jahre;2647;1418;1229
16054;      Suhl, krsfr. Stadt;45 bis unter 50 Jahre;3357;1697;1660
16054;      Suhl, krsfr. Stadt;50 bis unter 55 Jahre;3283;1646;1637
16054;      Suhl, krsfr. Stadt;55 bis unter 60 Jahre;3550;1643;1907
16054;      Suhl, krsfr. Stadt;60 bis unter 65 Jahre;3244;1566;1678
16054;      Suhl, krsfr. Stadt;65 bis unter 75 Jahre;6024;2840;3184
16054;      Suhl, krsfr. Stadt;75 Jahre und mehr;4128;1564;2564
16054;      Suhl, krsfr. Stadt;Insgesamt;38219;18827;19392
16055;      Weimar, krsfr. Stadt;unter 3 Jahre;1861;923;938
16055;      Weimar, krsfr. Stadt;3 bis unter 6 Jahre;1727;905;822
16055;      Weimar, krsfr. Stadt;6 bis unter 10 Jahre;2089;1071;1018
16055;      Weimar, krsfr. Stadt;10 bis unter 15 Jahre;2504;1261;1243
16055;      Weimar, krsfr. Stadt;15 bis unter 18 Jahre;1163;599;564
16055;      Weimar, krsfr. Stadt;18 bis unter 20 Jahre;903;418;485
16055;      Weimar, krsfr. Stadt;20 bis unter 25 Jahre;5102;2437;2665
16055;      Weimar, krsfr. Stadt;25 bis unter 30 Jahre;5415;2730;2685
16055;      Weimar, krsfr. Stadt;30 bis unter 35 Jahre;4789;2490;2299
16055;      Weimar, krsfr. Stadt;35 bis unter 40 Jahre;3863;2094;1769
16055;      Weimar, krsfr. Stadt;40 bis unter 45 Jahre;4497;2339;2158
16055;      Weimar, krsfr. Stadt;45 bis unter 50 Jahre;5092;2570;2522
16055;      Weimar, krsfr. Stadt;50 bis unter 55 Jahre;4586;2300;2286
16055;      Weimar, krsfr. Stadt;55 bis unter 60 Jahre;4337;2107;2230
16055;      Weimar, krsfr. Stadt;60 bis unter 65 Jahre;3834;1832;2002
16055;      Weimar, krsfr. Stadt;65 bis unter 75 Jahre;7459;3382;4077
16055;      Weimar, krsfr. Stadt;75 Jahre und mehr;6321;2236;4085
16055;      Weimar, krsfr. Stadt;Insgesamt;65542;31694;33848
16056;      Eisenach, krsfr. Stadt;unter 3 Jahre;1022;545;477
16056;      Eisenach, krsfr. Stadt;3 bis unter 6 Jahre;1024;528;496
16056;      Eisenach, krsfr. Stadt;6 bis unter 10 Jahre;1313;665;648
16056;      Eisenach, krsfr. Stadt;10 bis unter 15 Jahre;1530;784;746
16056;      Eisenach, krsfr. Stadt;15 bis unter 18 Jahre;727;388;339
16056;      Eisenach, krsfr. Stadt;18 bis unter 20 Jahre;518;247;271
16056;      Eisenach, krsfr. Stadt;20 bis unter 25 Jahre;2263;1153;1110
16056;      Eisenach, krsfr. Stadt;25 bis unter 30 Jahre;2750;1425;1325
16056;      Eisenach, krsfr. Stadt;30 bis unter 35 Jahre;2643;1411;1232
16056;      Eisenach, krsfr. Stadt;35 bis unter 40 Jahre;2317;1250;1067
16056;      Eisenach, krsfr. Stadt;40 bis unter 45 Jahre;3076;1613;1463
16056;      Eisenach, krsfr. Stadt;45 bis unter 50 Jahre;3582;1870;1712
16056;      Eisenach, krsfr. Stadt;50 bis unter 55 Jahre;3519;1781;1738
16056;      Eisenach, krsfr. Stadt;55 bis unter 60 Jahre;3032;1509;1523
16056;      Eisenach, krsfr. Stadt;60 bis unter 65 Jahre;2705;1298;1407
16056;      Eisenach, krsfr. Stadt;65 bis unter 75 Jahre;5914;2661;3253
16056;      Eisenach, krsfr. Stadt;75 Jahre und mehr;4726;1721;3005
16056;      Eisenach, krsfr. Stadt;Insgesamt;42661;20849;21812
16061;      Eichsfeld, Kreis;unter 3 Jahre;2796;1417;1379
16061;      Eichsfeld, Kreis;3 bis unter 6 Jahre;2725;1395;1330
16061;      Eichsfeld, Kreis;6 bis unter 10 Jahre;3718;1883;1835
16061;      Eichsfeld, Kreis;10 bis unter 15 Jahre;4423;2237;2186
16061;      Eichsfeld, Kreis;15 bis unter 18 Jahre;2289;1197;1092
16061;      Eichsfeld, Kreis;18 bis unter 20 Jahre;1524;811;713
16061;      Eichsfeld, Kreis;20 bis unter 25 Jahre;6016;3244;2772
16061;      Eichsfeld, Kreis;25 bis unter 30 Jahre;6974;3765;3209
16061;      Eichsfeld, Kreis;30 bis unter 35 Jahre;6564;3508;3056
16061;      Eichsfeld, Kreis;35 bis unter 40 Jahre;6034;3221;2813
16061;      Eichsfeld, Kreis;40 bis unter 45 Jahre;7426;3978;3448
16061;      Eichsfeld, Kreis;45 bis unter 50 Jahre;8971;4623;4348
16061;      Eichsfeld, Kreis;50 bis unter 55 Jahre;8711;4447;4264
16061;      Eichsfeld, Kreis;55 bis unter 60 Jahre;8414;4368;4046
16061;      Eichsfeld, Kreis;60 bis unter 65 Jahre;6709;3431;3278
16061;      Eichsfeld, Kreis;65 bis unter 75 Jahre;11962;5654;6308
16061;      Eichsfeld, Kreis;75 Jahre und mehr;9293;3427;5866
16061;      Eichsfeld, Kreis;Insgesamt;104549;52606;51943
16062;      Nordhausen, Kreis;unter 3 Jahre;2005;1053;952
16062;      Nordhausen, Kreis;3 bis unter 6 Jahre;2044;1022;1022
16062;      Nordhausen, Kreis;6 bis unter 10 Jahre;2620;1409;1211
16062;      Nordhausen, Kreis;10 bis unter 15 Jahre;3353;1698;1655
16062;      Nordhausen, Kreis;15 bis unter 18 Jahre;1685;898;787
16062;      Nordhausen, Kreis;18 bis unter 20 Jahre;1217;615;602
16062;      Nordhausen, Kreis;20 bis unter 25 Jahre;5498;2873;2625
16062;      Nordhausen, Kreis;25 bis unter 30 Jahre;5278;2915;2363
16062;      Nordhausen, Kreis;30 bis unter 35 Jahre;5013;2690;2323
16062;      Nordhausen, Kreis;35 bis unter 40 Jahre;4359;2328;2031
16062;      Nordhausen, Kreis;40 bis unter 45 Jahre;6461;3360;3101
16062;      Nordhausen, Kreis;45 bis unter 50 Jahre;7643;3948;3695
16062;      Nordhausen, Kreis;50 bis unter 55 Jahre;7601;3885;3716
16062;      Nordhausen, Kreis;55 bis unter 60 Jahre;7075;3512;3563
16062;      Nordhausen, Kreis;60 bis unter 65 Jahre;5770;2844;2926
16062;      Nordhausen, Kreis;65 bis unter 75 Jahre;11902;5562;6340
16062;      Nordhausen, Kreis;75 Jahre und mehr;9668;3518;6150
16062;      Nordhausen, Kreis;Insgesamt;89192;44130;45062
16063;      Wartburgkreis;unter 3 Jahre;2971;1527;1444
16063;      Wartburgkreis;3 bis unter 6 Jahre;2919;1546;1373
16063;      Wartburgkreis;6 bis unter 10 Jahre;3960;2022;1938
16063;      Wartburgkreis;10 bis unter 15 Jahre;4930;2534;2396
16063;      Wartburgkreis;15 bis unter 18 Jahre;2505;1289;1216
16063;      Wartburgkreis;18 bis unter 20 Jahre;1535;813;722
16063;      Wartburgkreis;20 bis unter 25 Jahre;6985;3806;3179
16063;      Wartburgkreis;25 bis unter 30 Jahre;7559;4116;3443
16063;      Wartburgkreis;30 bis unter 35 Jahre;7676;4108;3568
16063;      Wartburgkreis;35 bis unter 40 Jahre;7054;3798;3256
16063;      Wartburgkreis;40 bis unter 45 Jahre;9300;4902;4398
16063;      Wartburgkreis;45 bis unter 50 Jahre;11488;5917;5571
16063;      Wartburgkreis;50 bis unter 55 Jahre;11898;6155;5743
16063;      Wartburgkreis;55 bis unter 60 Jahre;10716;5517;5199
16063;      Wartburgkreis;60 bis unter 65 Jahre;9060;4533;4527
16063;      Wartburgkreis;65 bis unter 75 Jahre;15829;7360;8469
16063;      Wartburgkreis;75 Jahre und mehr;13099;4928;8171
16063;      Wartburgkreis;Insgesamt;129484;64871;64613
16064;      Unstrut-Hainich-Kreis;unter 3 Jahre;2604;1341;1263
16064;      Unstrut-Hainich-Kreis;3 bis unter 6 Jahre;2608;1360;1248
16064;      Unstrut-Hainich-Kreis;6 bis unter 10 Jahre;3593;1798;1795
16064;      Unstrut-Hainich-Kreis;10 bis unter 15 Jahre;4394;2260;2134
16064;      Unstrut-Hainich-Kreis;15 bis unter 18 Jahre;2343;1185;1158
16064;      Unstrut-Hainich-Kreis;18 bis unter 20 Jahre;1592;791;801
16064;      Unstrut-Hainich-Kreis;20 bis unter 25 Jahre;5767;3126;2641
16064;      Unstrut-Hainich-Kreis;25 bis unter 30 Jahre;6292;3394;2898
16064;      Unstrut-Hainich-Kreis;30 bis unter 35 Jahre;6560;3639;2921
16064;      Unstrut-Hainich-Kreis;35 bis unter 40 Jahre;5754;3214;2540
16064;      Unstrut-Hainich-Kreis;40 bis unter 45 Jahre;7857;4187;3670
16064;      Unstrut-Hainich-Kreis;45 bis unter 50 Jahre;9433;4828;4605
16064;      Unstrut-Hainich-Kreis;50 bis unter 55 Jahre;9544;4917;4627
16064;      Unstrut-Hainich-Kreis;55 bis unter 60 Jahre;8763;4424;4339
16064;      Unstrut-Hainich-Kreis;60 bis unter 65 Jahre;6914;3473;3441
16064;      Unstrut-Hainich-Kreis;65 bis unter 75 Jahre;13016;6002;7014
16064;      Unstrut-Hainich-Kreis;75 Jahre und mehr;11006;3899;7107
16064;      Unstrut-Hainich-Kreis;Insgesamt;108040;53838;54202
16065;      Kyffhäuserkreis;unter 3 Jahre;1676;887;789
16065;      Kyffhäuserkreis;3 bis unter 6 Jahre;1732;905;827
16065;      Kyffhäuserkreis;6 bis unter 10 Jahre;2360;1229;1131
16065;      Kyffhäuserkreis;10 bis unter 15 Jahre;3013;1548;1465
16065;      Kyffhäuserkreis;15 bis unter 18 Jahre;1555;791;764
16065;      Kyffhäuserkreis;18 bis unter 20 Jahre;1043;539;504
16065;      Kyffhäuserkreis;20 bis unter 25 Jahre;4092;2316;1776
16065;      Kyffhäuserkreis;25 bis unter 30 Jahre;4424;2446;1978
16065;      Kyffhäuserkreis;30 bis unter 35 Jahre;4381;2440;1941
16065;      Kyffhäuserkreis;35 bis unter 40 Jahre;3929;2089;1840
16065;      Kyffhäuserkreis;40 bis unter 45 Jahre;5587;2895;2692
16065;      Kyffhäuserkreis;45 bis unter 50 Jahre;7034;3596;3438
16065;      Kyffhäuserkreis;50 bis unter 55 Jahre;7412;3765;3647
16065;      Kyffhäuserkreis;55 bis unter 60 Jahre;7004;3570;3434
16065;      Kyffhäuserkreis;60 bis unter 65 Jahre;5661;2818;2843
16065;      Kyffhäuserkreis;65 bis unter 75 Jahre;10732;4991;5741
16065;      Kyffhäuserkreis;75 Jahre und mehr;8836;3132;5704
16065;      Kyffhäuserkreis;Insgesamt;80471;39957;40514
16066;      Schmalkalden-Meiningen, Kreis;unter 3 Jahre;2800;1481;1319
16066;      Schmalkalden-Meiningen, Kreis;3 bis unter 6 Jahre;2756;1385;1371
16066;      Schmalkalden-Meiningen, Kreis;6 bis unter 10 Jahre;3662;1861;1801
16066;      Schmalkalden-Meiningen, Kreis;10 bis unter 15 Jahre;4546;2309;2237
16066;      Schmalkalden-Meiningen, Kreis;15 bis unter 18 Jahre;2412;1296;1116
16066;      Schmalkalden-Meiningen, Kreis;18 bis unter 20 Jahre;1593;835;758
16066;      Schmalkalden-Meiningen, Kreis;20 bis unter 25 Jahre;7078;3810;3268
16066;      Schmalkalden-Meiningen, Kreis;25 bis unter 30 Jahre;7925;4445;3480
16066;      Schmalkalden-Meiningen, Kreis;30 bis unter 35 Jahre;7332;4025;3307
16066;      Schmalkalden-Meiningen, Kreis;35 bis unter 40 Jahre;6539;3523;3016
16066;      Schmalkalden-Meiningen, Kreis;40 bis unter 45 Jahre;9152;4818;4334
16066;      Schmalkalden-Meiningen, Kreis;45 bis unter 50 Jahre;11312;5719;5593
16066;      Schmalkalden-Meiningen, Kreis;50 bis unter 55 Jahre;11741;6007;5734
16066;      Schmalkalden-Meiningen, Kreis;55 bis unter 60 Jahre;10741;5457;5284
16066;      Schmalkalden-Meiningen, Kreis;60 bis unter 65 Jahre;8862;4375;4487
16066;      Schmalkalden-Meiningen, Kreis;65 bis unter 75 Jahre;16751;7750;9001
16066;      Schmalkalden-Meiningen, Kreis;75 Jahre und mehr;13598;5029;8569
16066;      Schmalkalden-Meiningen, Kreis;Insgesamt;128800;64125;64675
16067;      Gotha, Kreis;unter 3 Jahre;3243;1634;1609
16067;      Gotha, Kreis;3 bis unter 6 Jahre;3179;1652;1527
16067;      Gotha, Kreis;6 bis unter 10 Jahre;4346;2228;2118
16067;      Gotha, Kreis;10 bis unter 15 Jahre;5549;2896;2653
16067;      Gotha, Kreis;15 bis unter 18 Jahre;2725;1373;1352
16067;      Gotha, Kreis;18 bis unter 20 Jahre;1683;875;808
16067;      Gotha, Kreis;20 bis unter 25 Jahre;7236;3837;3399
16067;      Gotha, Kreis;25 bis unter 30 Jahre;7885;4310;3575
16067;      Gotha, Kreis;30 bis unter 35 Jahre;7797;4116;3681
16067;      Gotha, Kreis;35 bis unter 40 Jahre;7183;3882;3301
16067;      Gotha, Kreis;40 bis unter 45 Jahre;10132;5299;4833
16067;      Gotha, Kreis;45 bis unter 50 Jahre;12156;6285;5871
16067;      Gotha, Kreis;50 bis unter 55 Jahre;12119;6139;5980
16067;      Gotha, Kreis;55 bis unter 60 Jahre;11181;5624;5557
16067;      Gotha, Kreis;60 bis unter 65 Jahre;9325;4595;4730
16067;      Gotha, Kreis;65 bis unter 75 Jahre;17562;8175;9387
16067;      Gotha, Kreis;75 Jahre und mehr;14039;5111;8928
16067;      Gotha, Kreis;Insgesamt;137340;68031;69309
16068;      Sömmerda, Kreis;unter 3 Jahre;1694;857;837
16068;      Sömmerda, Kreis;3 bis unter 6 Jahre;1760;908;852
16068;      Sömmerda, Kreis;6 bis unter 10 Jahre;2350;1244;1106
16068;      Sömmerda, Kreis;10 bis unter 15 Jahre;2737;1387;1350
16068;      Sömmerda, Kreis;15 bis unter 18 Jahre;1465;747;718
16068;      Sömmerda, Kreis;18 bis unter 20 Jahre;923;510;413
16068;      Sömmerda, Kreis;20 bis unter 25 Jahre;3678;1963;1715
16068;      Sömmerda, Kreis;25 bis unter 30 Jahre;4044;2123;1921
16068;      Sömmerda, Kreis;30 bis unter 35 Jahre;4314;2303;2011
16068;      Sömmerda, Kreis;35 bis unter 40 Jahre;4013;2199;1814
16068;      Sömmerda, Kreis;40 bis unter 45 Jahre;5431;2846;2585
16068;      Sömmerda, Kreis;45 bis unter 50 Jahre;6498;3353;3145
16068;      Sömmerda, Kreis;50 bis unter 55 Jahre;6410;3200;3210
16068;      Sömmerda, Kreis;55 bis unter 60 Jahre;6546;3326;3220
16068;      Sömmerda, Kreis;60 bis unter 65 Jahre;5284;2683;2601
16068;      Sömmerda, Kreis;65 bis unter 75 Jahre;8498;4027;4471
16068;      Sömmerda, Kreis;75 Jahre und mehr;6700;2382;4318
16068;      Sömmerda, Kreis;Insgesamt;72345;36058;36287
16069;      Hildburghausen, Kreis;unter 3 Jahre;1471;718;753
16069;      Hildburghausen, Kreis;3 bis unter 6 Jahre;1479;765;714
16069;      Hildburghausen, Kreis;6 bis unter 10 Jahre;1987;1019;968
16069;      Hildburghausen, Kreis;10 bis unter 15 Jahre;2393;1224;1169
16069;      Hildburghausen, Kreis;15 bis unter 18 Jahre;1228;620;608
16069;      Hildburghausen, Kreis;18 bis unter 20 Jahre;839;456;383
16069;      Hildburghausen, Kreis;20 bis unter 25 Jahre;3584;1946;1638
16069;      Hildburghausen, Kreis;25 bis unter 30 Jahre;4293;2389;1904
16069;      Hildburghausen, Kreis;30 bis unter 35 Jahre;4043;2227;1816
16069;      Hildburghausen, Kreis;35 bis unter 40 Jahre;3648;1964;1684
16069;      Hildburghausen, Kreis;40 bis unter 45 Jahre;4687;2450;2237
16069;      Hildburghausen, Kreis;45 bis unter 50 Jahre;5904;3054;2850
16069;      Hildburghausen, Kreis;50 bis unter 55 Jahre;6159;3180;2979
16069;      Hildburghausen, Kreis;55 bis unter 60 Jahre;5609;2862;2747
16069;      Hildburghausen, Kreis;60 bis unter 65 Jahre;4458;2219;2239
16069;      Hildburghausen, Kreis;65 bis unter 75 Jahre;7727;3588;4139
16069;      Hildburghausen, Kreis;75 Jahre und mehr;6798;2355;4443
16069;      Hildburghausen, Kreis;Insgesamt;66307;33036;33271
16070;      Ilm-Kreis;unter 3 Jahre;2505;1260;1245
16070;      Ilm-Kreis;3 bis unter 6 Jahre;2565;1327;1238
16070;      Ilm-Kreis;6 bis unter 10 Jahre;3182;1563;1619
16070;      Ilm-Kreis;10 bis unter 15 Jahre;4045;2056;1989
16070;      Ilm-Kreis;15 bis unter 18 Jahre;1944;1012;932
16070;      Ilm-Kreis;18 bis unter 20 Jahre;1449;791;658
16070;      Ilm-Kreis;20 bis unter 25 Jahre;7037;4023;3014
16070;      Ilm-Kreis;25 bis unter 30 Jahre;6859;3783;3076
16070;      Ilm-Kreis;30 bis unter 35 Jahre;6635;3628;3007
16070;      Ilm-Kreis;35 bis unter 40 Jahre;5510;2981;2529
16070;      Ilm-Kreis;40 bis unter 45 Jahre;8122;4306;3816
16070;      Ilm-Kreis;45 bis unter 50 Jahre;9579;4962;4617
16070;      Ilm-Kreis;50 bis unter 55 Jahre;9334;4766;4568
16070;      Ilm-Kreis;55 bis unter 60 Jahre;9102;4466;4636
16070;      Ilm-Kreis;60 bis unter 65 Jahre;7890;3916;3974
16070;      Ilm-Kreis;65 bis unter 75 Jahre;14465;6707;7758
16070;      Ilm-Kreis;75 Jahre und mehr;11536;4086;7450
16070;      Ilm-Kreis;Insgesamt;111759;55633;56126
16071;      Weimarer Land, Kreis;unter 3 Jahre;2095;1048;1047
16071;      Weimarer Land, Kreis;3 bis unter 6 Jahre;2128;1093;1035
16071;      Weimarer Land, Kreis;6 bis unter 10 Jahre;2870;1456;1414
16071;      Weimarer Land, Kreis;10 bis unter 15 Jahre;3436;1739;1697
16071;      Weimarer Land, Kreis;15 bis unter 18 Jahre;1753;873;880
16071;      Weimarer Land, Kreis;18 bis unter 20 Jahre;961;462;499
16071;      Weimarer Land, Kreis;20 bis unter 25 Jahre;4250;2273;1977
16071;      Weimarer Land, Kreis;25 bis unter 30 Jahre;4850;2612;2238
16071;      Weimarer Land, Kreis;30 bis unter 35 Jahre;5032;2568;2464
16071;      Weimarer Land, Kreis;35 bis unter 40 Jahre;4743;2554;2189
16071;      Weimarer Land, Kreis;40 bis unter 45 Jahre;6366;3302;3064
16071;      Weimarer Land, Kreis;45 bis unter 50 Jahre;7645;3932;3713
16071;      Weimarer Land, Kreis;50 bis unter 55 Jahre;7600;3776;3824
16071;      Weimarer Land, Kreis;55 bis unter 60 Jahre;7349;3757;3592
16071;      Weimarer Land, Kreis;60 bis unter 65 Jahre;6067;3126;2941
16071;      Weimarer Land, Kreis;65 bis unter 75 Jahre;9417;4463;4954
16071;      Weimarer Land, Kreis;75 Jahre und mehr;7717;2793;4924
16071;      Weimarer Land, Kreis;Insgesamt;84279;41827;42452
16072;      Sonneberg, Kreis;unter 3 Jahre;1176;580;596
16072;      Sonneberg, Kreis;3 bis unter 6 Jahre;1205;600;605
16072;      Sonneberg, Kreis;6 bis unter 10 Jahre;1707;926;781
16072;      Sonneberg, Kreis;10 bis unter 15 Jahre;2071;1068;1003
16072;      Sonneberg, Kreis;15 bis unter 18 Jahre;1016;518;498
16072;      Sonneberg, Kreis;18 bis unter 20 Jahre;709;383;326
16072;      Sonneberg, Kreis;20 bis unter 25 Jahre;2991;1610;1381
16072;      Sonneberg, Kreis;25 bis unter 30 Jahre;3330;1817;1513
16072;      Sonneberg, Kreis;30 bis unter 35 Jahre;3261;1797;1464
16072;      Sonneberg, Kreis;35 bis unter 40 Jahre;3092;1681;1411
16072;      Sonneberg, Kreis;40 bis unter 45 Jahre;4194;2207;1987
16072;      Sonneberg, Kreis;45 bis unter 50 Jahre;5166;2637;2529
16072;      Sonneberg, Kreis;50 bis unter 55 Jahre;5320;2717;2603
16072;      Sonneberg, Kreis;55 bis unter 60 Jahre;5053;2534;2519
16072;      Sonneberg, Kreis;60 bis unter 65 Jahre;4232;2101;2131
16072;      Sonneberg, Kreis;65 bis unter 75 Jahre;7905;3621;4284
16072;      Sonneberg, Kreis;75 Jahre und mehr;6821;2318;4503
16072;      Sonneberg, Kreis;Insgesamt;59249;29115;30134
16073;      Saalfeld-Rudolstadt, Kreis;unter 3 Jahre;2431;1229;1202
16073;      Saalfeld-Rudolstadt, Kreis;3 bis unter 6 Jahre;2313;1197;1116
16073;      Saalfeld-Rudolstadt, Kreis;6 bis unter 10 Jahre;3151;1601;1550
16073;      Saalfeld-Rudolstadt, Kreis;10 bis unter 15 Jahre;4030;2077;1953
16073;      Saalfeld-Rudolstadt, Kreis;15 bis unter 18 Jahre;1977;1018;959
16073;      Saalfeld-Rudolstadt, Kreis;18 bis unter 20 Jahre;1213;648;565
16073;      Saalfeld-Rudolstadt, Kreis;20 bis unter 25 Jahre;5990;3303;2687
16073;      Saalfeld-Rudolstadt, Kreis;25 bis unter 30 Jahre;6491;3533;2958
16073;      Saalfeld-Rudolstadt, Kreis;30 bis unter 35 Jahre;6037;3262;2775
16073;      Saalfeld-Rudolstadt, Kreis;35 bis unter 40 Jahre;5805;3125;2680
16073;      Saalfeld-Rudolstadt, Kreis;40 bis unter 45 Jahre;8200;4380;3820
16073;      Saalfeld-Rudolstadt, Kreis;45 bis unter 50 Jahre;10119;5263;4856
16073;      Saalfeld-Rudolstadt, Kreis;50 bis unter 55 Jahre;10383;5321;5062
16073;      Saalfeld-Rudolstadt, Kreis;55 bis unter 60 Jahre;9731;4960;4771
16073;      Saalfeld-Rudolstadt, Kreis;60 bis unter 65 Jahre;7876;3909;3967
16073;      Saalfeld-Rudolstadt, Kreis;65 bis unter 75 Jahre;15896;7286;8610
16073;      Saalfeld-Rudolstadt, Kreis;75 Jahre und mehr;14079;4957;9122
16073;      Saalfeld-Rudolstadt, Kreis;Insgesamt;115722;57069;58653
16074;      Saale-Holzland-Kreis;unter 3 Jahre;1932;945;987
16074;      Saale-Holzland-Kreis;3 bis unter 6 Jahre;1935;998;937
16074;      Saale-Holzland-Kreis;6 bis unter 10 Jahre;2666;1398;1268
16074;      Saale-Holzland-Kreis;10 bis unter 15 Jahre;3366;1724;1642
16074;      Saale-Holzland-Kreis;15 bis unter 18 Jahre;1671;844;827
16074;      Saale-Holzland-Kreis;18 bis unter 20 Jahre;1054;540;514
16074;      Saale-Holzland-Kreis;20 bis unter 25 Jahre;4400;2367;2033
16074;      Saale-Holzland-Kreis;25 bis unter 30 Jahre;4882;2635;2247
16074;      Saale-Holzland-Kreis;30 bis unter 35 Jahre;4950;2695;2255
16074;      Saale-Holzland-Kreis;35 bis unter 40 Jahre;4558;2431;2127
16074;      Saale-Holzland-Kreis;40 bis unter 45 Jahre;6341;3389;2952
16074;      Saale-Holzland-Kreis;45 bis unter 50 Jahre;7851;3982;3869
16074;      Saale-Holzland-Kreis;50 bis unter 55 Jahre;7754;3963;3791
16074;      Saale-Holzland-Kreis;55 bis unter 60 Jahre;7367;3774;3593
16074;      Saale-Holzland-Kreis;60 bis unter 65 Jahre;6022;2979;3043
16074;      Saale-Holzland-Kreis;65 bis unter 75 Jahre;10982;5244;5738
16074;      Saale-Holzland-Kreis;75 Jahre und mehr;8572;3084;5488
16074;      Saale-Holzland-Kreis;Insgesamt;86303;42992;43311
16075;      Saale-Orla-Kreis;unter 3 Jahre;1945;969;976
16075;      Saale-Orla-Kreis;3 bis unter 6 Jahre;1892;1008;884
16075;      Saale-Orla-Kreis;6 bis unter 10 Jahre;2544;1317;1227
16075;      Saale-Orla-Kreis;10 bis unter 15 Jahre;3411;1665;1746
16075;      Saale-Orla-Kreis;15 bis unter 18 Jahre;1675;820;855
16075;      Saale-Orla-Kreis;18 bis unter 20 Jahre;1037;556;481
16075;      Saale-Orla-Kreis;20 bis unter 25 Jahre;4454;2414;2040
16075;      Saale-Orla-Kreis;25 bis unter 30 Jahre;5022;2720;2302
16075;      Saale-Orla-Kreis;30 bis unter 35 Jahre;4881;2666;2215
16075;      Saale-Orla-Kreis;35 bis unter 40 Jahre;4488;2394;2094
16075;      Saale-Orla-Kreis;40 bis unter 45 Jahre;6061;3131;2930
16075;      Saale-Orla-Kreis;45 bis unter 50 Jahre;7643;3947;3696
16075;      Saale-Orla-Kreis;50 bis unter 55 Jahre;7852;4049;3803
16075;      Saale-Orla-Kreis;55 bis unter 60 Jahre;7487;3839;3648
16075;      Saale-Orla-Kreis;60 bis unter 65 Jahre;5959;2921;3038
16075;      Saale-Orla-Kreis;65 bis unter 75 Jahre;10694;4977;5717
16075;      Saale-Orla-Kreis;75 Jahre und mehr;9861;3458;6403
16075;      Saale-Orla-Kreis;Insgesamt;86906;42851;44055
16076;      Greiz, Kreis;unter 3 Jahre;2084;1039;1045
16076;      Greiz, Kreis;3 bis unter 6 Jahre;2179;1165;1014
16076;      Greiz, Kreis;6 bis unter 10 Jahre;3013;1565;1448
16076;      Greiz, Kreis;10 bis unter 15 Jahre;3886;2019;1867
16076;      Greiz, Kreis;15 bis unter 18 Jahre;2010;1034;976
16076;      Greiz, Kreis;18 bis unter 20 Jahre;1191;650;541
16076;      Greiz, Kreis;20 bis unter 25 Jahre;4834;2652;2182
16076;      Greiz, Kreis;25 bis unter 30 Jahre;5253;2883;2370
16076;      Greiz, Kreis;30 bis unter 35 Jahre;5634;3156;2478
16076;      Greiz, Kreis;35 bis unter 40 Jahre;4970;2620;2350
16076;      Greiz, Kreis;40 bis unter 45 Jahre;7369;3717;3652
16076;      Greiz, Kreis;45 bis unter 50 Jahre;9573;4931;4642
16076;      Greiz, Kreis;50 bis unter 55 Jahre;9654;4844;4810
16076;      Greiz, Kreis;55 bis unter 60 Jahre;9598;4893;4705
16076;      Greiz, Kreis;60 bis unter 65 Jahre;7572;3820;3752
16076;      Greiz, Kreis;65 bis unter 75 Jahre;14334;6596;7738
16076;      Greiz, Kreis;75 Jahre und mehr;12848;4612;8236
16076;      Greiz, Kreis;Insgesamt;106002;52196;53806
16077;      Altenburger Land, Kreis;unter 3 Jahre;1850;899;951
16077;      Altenburger Land, Kreis;3 bis unter 6 Jahre;1934;988;946
16077;      Altenburger Land, Kreis;6 bis unter 10 Jahre;2653;1354;1299
16077;      Altenburger Land, Kreis;10 bis unter 15 Jahre;3494;1806;1688
16077;      Altenburger Land, Kreis;15 bis unter 18 Jahre;1680;860;820
16077;      Altenburger Land, Kreis;18 bis unter 20 Jahre;1109;587;522
16077;      Altenburger Land, Kreis;20 bis unter 25 Jahre;4665;2546;2119
16077;      Altenburger Land, Kreis;25 bis unter 30 Jahre;4916;2707;2209
16077;      Altenburger Land, Kreis;30 bis unter 35 Jahre;4892;2600;2292
16077;      Altenburger Land, Kreis;35 bis unter 40 Jahre;4563;2491;2072
16077;      Altenburger Land, Kreis;40 bis unter 45 Jahre;7036;3620;3416
16077;      Altenburger Land, Kreis;45 bis unter 50 Jahre;8495;4395;4100
16077;      Altenburger Land, Kreis;50 bis unter 55 Jahre;8177;4150;4027
16077;      Altenburger Land, Kreis;55 bis unter 60 Jahre;8409;4175;4234
16077;      Altenburger Land, Kreis;60 bis unter 65 Jahre;7158;3465;3693
16077;      Altenburger Land, Kreis;65 bis unter 75 Jahre;14154;6641;7513
16077;      Altenburger Land, Kreis;75 Jahre und mehr;12258;4303;7955
16077;      Altenburger Land, Kreis;Insgesamt;97443;47587;49856
